am -iin	amiin
l -aa	laa
gaa-l	gaal
ḥas-ab	ḥasab
hi-nd	hind
ḥat -ta	ḥatta
ak -tar	aktar
yimk- -een	yimkeen
ḥaẓ- -aa-r	ḥaẓaar
paap- -ii-r-om	paapiir -o-m
paap- -ii-r-os	paapiir -o-s
paap- -ii-r-or	paapiir -o-r
turkii -ya	turkiiya
gaaka- -r-aa	gaa-kar-aa
ḍ -o-m	ḍom
ab -o-r	ab-or
libn- -aa-n	 libnaan
aḥ -yaan	aḥyaan
ḍo -mà	ḍom -à
m -aa	maa
ḍ -o-maa	ḍom -aa
p- -ird-	pir- -d-
p -aa	paa
as- -aa-s	asaas
iš -šii	iššii
ḥit -ta	ḥitta
falasṭ -iin	falasṭiin
biẓẓab -it	biẓẓabit
ziiv- -r-aa	ziivraa- 
maa-rd-	maar-d-
daa- -d	daad
ġ- -ee-r	ġeer
aa- -r-ee	aaree
ni- -im	niim
baʕ- -d-een	baʕdeen
kur- yin	kury -in
pk- -ees	pkees
baʕid -ma	baʕidma
bn- -aa-n	bnaan
paa- -rd	paar- -d
bilʕaa- -d-ee	bilʕaadee
maa- -rd	maar- -d
uu -ta	uuta
h -aa	haa
iit -ta	iitta
mar- -r-à	marrà
wala -tà	walat -à
m- -een	meen
mš- -aa-n	mšaan
t -aa	taa
ab -o-m	ab-om
or -iin	oriin
va-rd	var-d
vaa-rd	vaar-d
o -ta	ota
k- -aa-n	kaan
suur -yaa	suuryaa
kak -kà	kakkà
ee -ta	eeta
ṣaa- -l-à	ṣaal -à
laav- -č-is	laavč -is
vaar-yis	vaary -is
neen- -d	n- -eend
ḥamm- -aa-m	ḥammaam
kur -yim	kury -im
jazaa’- -ee-r	jazaa’eer
balji -ika	baljiika
t- -een	teen
ṣ -aa	ṣaa
ṣayṭa- -r-à	ṣayṭarà
maʕaaša- -r-om-aa	maʕaašar-omaa
ay-ya	ayya
vy- -aa-r	vyaar
qaa- -l-à	qaal- -à
baa- -r-à	baarà
ti -ika	tiika
m -iin	miin
ka -tà	katà
ʕas- -kar	ʕaskar
ami- -in-kii	amiin -kii
-vaa -šii	vaaš-ii
daa -yim	daay -im
t- -aa-r	taar
paaṣo -ma	paaṣ-oma
kul -ka	kulka
ay -ya	ayya
ab -o-s	ab-os
ḥa- -št	ḥašt
ʕaa- -d-à	ʕaadà
qabil -ma	qabilma
gee-n-aa	geenaa
din -ya	dinya
laaz -im	laazim
j- -aa-r	jaa- -r
qadi -im	qadiim
arbiiʕ -iin	arbiiʕiin
si- -n-ee	sinee
xayy- -ir	xayyir
qlaa- -r-à	qlaarà
y -o-m	yom
iliiy- -aa-m	il- iiyaam
il’- -aa-n	il’aan
greevaa- -r	greevaar
ago- -r	agor
faq- -ii-r	faqiir
tiim- -aa-r	tiimaar
ka -kii	kakii
m- -r-à	mr-à
lam -ma	lamma
assal- -aa-m	assalaam
ʕalayk -o-m	ʕalaykom
juw- -r	juwr
beef -kà	beefkà
almoh -o-m	almohom
var -saa	vars -aa
ʕyaa- -d-à	ʕyaadà
faran -saa	faransaa
aas -yaa	aasyaa
d- -yaa-r	dyaar-
kaa -mor	kaamor
k- -o-n	ko- -n
vaa- -rd	vaar- -d
abom	ab-om
taʕbaa- -n	taʕbaan
qu- -r-om	qur -o-m
k- -see	ksee
h- -ind	hind
ḍ -o-m	ḍom
jib -	jib-
tmaar -iin	tmaariin
m -een	meen
am -een	ameen
dar -saa	dars -aa
lim -ma	limma
i- -iraan	iiraan
kee -va	keeva
lag- -aa-n	lagaan
m- -r-ee	mr-ee
pk -ee-s	pkees
vee -šii	veeš-ii
vaaš -o-maan	vaaš-omaan
ft-om	ft- -om
baxš -iiš	baxšiiš
xaan -im	xaanim
ẓ- -o-r	ẓor
bas- -see	bassee
xat- -r-à	xatrà
di- -d-à	didà
ijj -aa	ijjaa
vyaa- -r-à	vyaar -à
ab -o-saa	ab-osaa
yee -ka	yeeka
fl- -aa-n	flaan
saʕ -it	saʕit
lip- -aa-r	li- paar-
var- -s	vars -
daa -yim	daayim
xuḍ- -r-ee	xuḍree
tajaa- -r-à	tajaarà
ha- -n-ee	hanee
ii -ta	iita
karaawi -it	karaawiit 
lvaa- -l-à	lvaal- -à
laʕẓi -im	laʕẓiim
ḥo- -š	ḥoš 
ṭil -l-à	ṭill- -à
ha -yaa	hay -aa
la -ka	laka
inzo- -r-à	inzorà
x -ee-r	xeer
ko -ma	koma
g- -aa-m	gaam
ġoṭi- -iš	ġoṭiiš
qu- -r	qur 
yirḥa -ma	yirḥama
paš -tar	paštar
maa-nd	maan- -d
t -een	teen
qaw- -r	qawr
ʕum- -r	ʕumr
suk -it	sukit
a -kii	akii
tn -een	tneen
suurii -ya	suuriiya
ḥaa- -r	ḥaar
ab- -o-r	ab-or
ami -in	amiin
or -in	orin
fat- -r	fatr 
t- -aa-v	taav
š- -aa-m	šaam
ni -im	niim
iiqaa -mà	iiqaamà
ʕa -adii	ʕaadii
mad- -d-ee	maddee
dan- -d-à	dand -à
ġ -ee-r	ġeer
ʕim- -ir	ʕimir
zee- -d	zeed
g- -aa-rd	gaar- -d
ilbaʕr- -aa-n	ilbaʕraan
tor- -d	to- -rd
ṭro -tà	ṭrot- -à
paa -yis	paay-is
vid -yin	vidy -in
vid -yis	vidy -is
pee- -nd	peen- -d
drongà	drong- -à
xarmaanà	xarmaan- -à
injaan-	in- jaan-
inqaa-	in- qaa-
ko -mà	komà
f -im	fim-
p- -r-ee	pree
qjiib- -o-raan	qjiiboraan
warsi- -ind	warsiind
pa- -š-im	pašim
p- -č	pč-
k -een	keen
d- -aa-m	daam
ʕa- -l-ee	ʕalee
k -een	keen
š -kà	šk- -à
karmi- -see	-kar-m-is-ee
gaa- -rd	gaar- -d
piš -ta	pišta
k -aak	kaak
da -adii	daadii
injaan-	in- jaan-
j- -aa	jaa-  
kur -yim	kury -im
zakk- -ir	zakkir- 
di- -isaa	diis -aa
hana -adii	hanaadii
p- -naa-r	pnaar- 
eef- -aa-n	eefaan
štuu- -n	štuun
štuu - -n	štuun
čaaḍ- -ir	čaaḍir
jis- -r	jisr 
gav- -r	gavr- 
ṭil- -l	ṭill- 
ʕaa- -rd	ʕaard 
ṣax- -r	ṣaxr 
warsiin- -d-à	warsiindà
ṣan -ta	ṣanta
paariigaa- -n	paariigaan
paariigaa - -n	paariigaan
bn -o-maa	bn-omaa
kaa- -št	kaašt
fraa- -š	fraaš 
daad-om	daad -o-m
b- -yaa	byaa- 
gav- -r	gavr- 
bara -kaa	barakaa
čan- -č	čanč
ʕa- -l-ee	ʕalee
si- -tt-à	sitt-à
k -ee-s	kees
tirkmaa- -n	tirkmaan
vind- -ir	vindir- -
s -in	sin
m- -aa-s	maas
aḥma- -d	aḥmad
a- -m-aa	amaa
braahi -im	braahiim
ṭr -in	ṭrin
bil’ajaa- -r	bil’ajaar
ḍ- -aa-m	ḍaam
maaṣo- -n-aa	maaṣon -aa
kur -yaa	kury -aa
v -ee-saa	vees- -aa
kuryaa	kury -aa
kur -yim	kury -im
la- -d-à	ladà
s- -r-os	sr -o-s
ḥat -tii	ḥattii
kur -yis	kury -is
kuw -aak	kuwaak
iy -ya	iyya
yo -kaa	yokaa
p- -aa-rd	paar- -d
qab -yaa	qaby -aa
pač -yaa	pačy -aa
kuryà	kury -à
bààbosk	bààb-o-s -k
ha -yin	hay -in
kaa -kà	kaakà
m- -aa-rd	maar- -d
juv- -r-os	juvr -o-s
eer -iin	eeriin
b- -n-aa	bn-aa
afriiq -ya	afriiqya
qur-os	qur -o-s
ʕaard-aa	ʕaard -aa
laav -tii	laavtii
indee	in- dee
been-om	been -o-m
jayraa- -n-ee	jayraanee
m- -ir-à	mir-à
dii- -see	diis -ee
daad-os	daad -o-s
y- -o-m-ee	yomee
ha -yis	hay -is
maktuu- -m-aa	maktuumaa
hawii -yaa	hawiiy -aa
jamii- -l-à	jamiil -à
daf -tar	daftar
šak- -kar	šakkar
laak -in	laakin
ṭroṭà	ṭroṭ- -à
xaštom	xašt -o-m
minsom	mins -o-m
kil- -m-ee	kilmee
diitr -in	diitrin
meeza- -r	meezar
indak	in- dak-
bààbom	bààb -o-m
iiz- -aa-r	iizaar
daa -yim	daayim
mjad- -r-à	mjadrà
limaar-	li- maar- 
màà -mor	mààm -o-r
kamis	kam -is
jiv- -ir	jivir
ḍolč -iin	ḍolčiin
bààbis	bààb -is
ftee	ft- -ee
likaris	li- kar- -is
miiš- -aa-n	miišaan
qaap -yis	qaapy -is
m -in	min
eevaa- -r-à	eevaarà
dormač- -aa-r	dormačaar
saʕ -tii	saʕtii
ballor- -aa	balloraa
hat -ta	hatta
ma -ma	mama
sow -in	sowin
lifikn-	li- fikn-
harka- -m-ee	harkam -ee
tjaa- -r-à	tjaarà
kuryomaa	kury -o-maa
nii -ya	niiya
čat-iin-ee	čatiin- -ee
ṭa -ma	ṭama
eer -in	eerin
kaa -ka	kaaka
inga-	in- ga-
kučmaa- -r-à	kučmaarà
ča- -rd-à	čar- -d-à
lifikn	li- fikn-
lipaar-	li- paar-
sitt -in	sittin
yeek -in	yeekin
injaa-	in- jaa-
p- -išt-aa	pištaa
paaw -o-s	paaw-os
innee-	in- nee-
ṣaḍḍ- -aa-m	ṣaḍḍaam
arz- -aa-n	arzaan
subḥ- -aa-n	subḥaan
manjaa- -n	manjaan
ḥaẓaa- -r-aa	ḥaẓaar -aa
ḥaẓaa- -r-à	ḥaẓaar -à
girdaa - -n-aa	girdaan -aa
čan -yaa	čany -aa
haraa -kà	haraakà
buuta- -r-ee	buutar -ee
zimmee- -š-ee	zimmeeš -ee
m -in	min
draa- -n-ee	draan- -ee
vaa- -l-ee	vaal- -ee
naẓ- -ii-r-ee	naẓiir -ee
baa- -r-om	baar -o-m
k- -o-r	ko- -r
pištos-	pišt -o-s
innee-	in- nee-
invak-	in- vak-
aandimaanee	- -aa-nd-imaan-ee
maʕal -ma	maʕalma
gunn -ee-m	gunnee -m
sl -ee-maan	sleemaan
drongee	drong- -ee
šammuu -saa	šammuusaa
ša- -m-s-ee	šamsee
sow- -in-ee	sowin -ee
lištaal-	li- štaal-
ʕaaṣ- -m-ee	ʕaaṣmee
hanaayee	hanaa-yee
ààros- -aa-m	ààr-osaa -m
baav- -l-à	baavlà
sror	sr -o-r
lʕaẓi -im	lʕaẓiim
kam- -aa-n	kamaan
jaa -yiin	jaayiin
lḥi -im	lḥiim
ki -iva	kiiva
nar- -n-ee	narnee
sleemaa - -n-aa	sleemaanaa
amm -in	ammin
bd- -ee-r	bdee- -r
maṭ- -aa-r	maṭaar
peešmeen- -d-aa	peešmeend -aa
tav- -n-ee	tavn -ee
ha - -n-aa	hanaa
duul- -aa-r	duulaar
tik -ka	tikka
x- -r-os	xr -o-s
eḥ - -n-aa	eḥnaa
bissij -in	bi- -s- -sijin
m -in	min
karto - -n-aa	karton -aa
ka -yaa	kay -aa
lito-	li- to-
lit-	li- t-
sn- -aa-n	snaan
-vaa -	vaa-
ḥara -kà	ḥarakà
biibyom	biiby -o-m
ḍar- -ii-r-ee	ḍariir -ee
insak-	in- sak-
xat- -r-aa	xatr -aa
š -kii	šk- -ii
bd- -aa-r	bdaar
pnàà- -r-à	pnààr- -à
l -ivaa	livaa
ʕusm- -aa-n	ʕusmaan
treeziil- -aa-m	treeziilaa -m
q- -aa-m-ee	qaa- -m-ee
inqa-	in- qa-
ha -adii	haadii
qlee- -d-ees	qleed-ees
ġazaa- -l-ee	ġazaalee
vanii- -št	vaniišt
bṭ -in	bṭin
kamyo - -n-aa	kamyon -aa
ball- -o-r	ballor
hat -tii	hattii
qa- -l-ee	qal -ee
ba- -k-r-à	bakr -à
ilḥii- -l-ee	ilḥiilee
wilftii- -l-ee	wilftiilee
jarb -aa	jarbaa
lifk -in	li- fkin-
xa- -št	xašt
vaa- -l-à	vaal- -à
zaʕfar- -aa-n	zaʕfaraan
naa- -n-aa	naan- -aa
afyuu- -n-ee	afyuunee
daawuu- -d-ee	daawuudee
ha -adii	haadii
ḥass- -ii-r-à	ḥassiirà
jn -een	jneen
m- -išt-ee	mišt- -ee
aa- -n-ee	aan- -ee
puuḥaa- -l-ee	puuḥaal- -ee
kajjaa-	ka-jjaa-
zee -va	zeeva
anṭaak -ya	anṭaakya
fqaa- -r-à	fqaar- -à
das -tà	dastà
laaz- -im-ee	laazim -ee
suuj -in	suujin
t- -o-nd-ee	to- -nd-ee
ʕaska- -r-ee	ʕaskar -ee
kaam -mor	kaammor
kay -yaa	kayaa
peer- -aa	peeraa-
ṣow -in	ṣowin
misir-yin	misiry -in
m -išt	mišt- 
inlak-	in- lak- 
ma-r-à	marà
yo-ka	yoka
g-aa-n	gaan
i-is	iis