-à	-GEN/M/OBL.SG
-a	-INDEF
-aa	-REM/2SG/INDEF/CAUS
-aa-m	-CAUS-1SG
-aa-m-aa	-CAUS-1SG-REM
-aa-m-ee	-CAUS-1SG-PRES
-aaw-om		-CAUS-1SG
-aaw-omaa	-CAUS-1PL
-aa-n	-CAUS-1PL
-aa-n-aa	-CAUS-1PL-REM
-n-aa	-1PL-REM
-n-is-ee	-1PL-3SG-PRES
-n-is	-1PL-3SG
-aa-n-ee	-CAUS-1PL-PRES
-aa-nd	-CAUS-3PL
-aa-nd-aa	-CAUS-3PL-REM
-aa-nd-ee	-CAUS-3PL-PRES
-aa-nd-is-aa	-CAUS-3PL-3SG-REM
-aa-nd-is-ee	-CAUS-3PL-3SG-PRES
-aa-nd-is	-CAUS-3PL-3SG
-aa-r	-CAUS-3SG
-aa-r-aa	-CAUS-3SG-REM
-aa-r-ee	-CAUS-3SG-PRES
-aa-r-à	-CAUS-PFV-3SG
-aa-r-is	-CAUS-3SG-3SG
-aa-s	-CAUS-2PL
-aa-s-aa	-CAUS-2PL-REM
-aa-s-ee	-CAUS-2PL-PRES
-aa-s-imaan-ee	-CAUS-2PL-1PL-PRES
-aa-s-imaan	-CAUS-2PL-1PL-REM
-aa-s-imaan	-CAUS-2PL-1PL
-aa-vaa	-CAUS-2SG
-vee	-2SG
-aak	-INDEF
-aar	-CAUS
-aar-d-ee	-CAUS-PFV-PRES
-aar-d-eend-is	-CAUS-PFV-3PL-3SG
-aar-d-om-ee	-CAUS-PFV-1SG-PRES
-aar-d-om-aa	-CAUS-PFV-1SG-REM
-aar-d-om	-CAUS-PFV-1SG
-aar-r-s-ee	-CAUS-3SG-3SG-PRES
-aav-iš-aa	-CAUS-SUBJ-REM
-aav-iš-ee	-CAUS-SUBJ-PRES
-aav-iš-ind	-CAUS-SUBJ-3PL
-aav-iš-ind-aa	-CAUS-SUBJ-3PL-REM
-aav-iš-ind-ee	-CAUS-SUBJ-3PL-PRES
-aav-iš-inn	-CAUS-SUBJ-1PL
-aav-iš-inn-aa	-CAUS-SUBJ-1PL-REM
-aav-iš-inn-ee	-CAUS-SUBJ-1PL-PRES
-aav-iš-iss	-CAUS-SUBJ-2PL
-aav-iš-iss-aa	-CAUS-SUBJ-2PL-REM
-aav-iš-iss-ee	-CAUS-SUBJ-2PL-PRES
-aav-iš-om	-CAUS-SUBJ-1SG
-aav-iš-om-aa	-CAUS-SUBJ-1SG-REM
-aav-iš-om-ee	-CAUS-SUBJ-1SG-PRES
-aav-iš-or	-CAUS-SUBJ-2SG
-aav-iš-or-aa	-CAUS-SUBJ-2SG-REM
-aav-iš-or-ee	-CAUS-SUBJ-2SG-PRES
-aav-išt-aa	-CAUS-PROG-REM
-aav-išt-ee	-CAUS-PROG-PRES
-aav-išt-ind	-CAUS-PROG-3PL
-aav-išt-ind-aa	-CAUS-PROG-3PL-REM
-aav-išt-ind-ee	-CAUS-PROG-3PL-PRES
-aav-išt-inn	-CAUS-PROG-1PL
-aav-išt-inn-aa	-CAUS-PROG-1PL-REM
-aav-išt-inn-ee	-CAUS-PROG-1PL-PRES
-aav-išt-iss	-CAUS-PROG-2PL
-aav-išt-iss-aa	-CAUS-PROG-2PL-REM
-aav-išt-iss-ee	-CAUS-PROG-2PL-PRES
-aav-išt-om	-CAUS-PROG-1SG
-aav-išt-om-aa	-CAUS-PROG-1SG-REM
-aav-išt-om-ee	-CAUS-PROG-1SG-PRES
-aav-išt-or	-CAUS-PROG-2SG
-aav-išt-or-aa	-CAUS-PROG-2SG-REM
-aav-išt-or-ee	-CAUS-PROG-2SG-PRES
-adii	-one.more
-ak	-INDEF
-ity-aa	-SUBJ-2SG
-ity-im	-SUBJ-1SG
-ity-im-aa	-SUBJ-1SG-REM
-ity-in	-SUBJ-1PL
-ity-ind	-SUBJ-3PL
-ity-ir	-SUBJ-3SG
-ity-er	-SUBJ-3SG
-ity-ir-is	-SUBJ-3SG-3SG
-ity-is	-SUBJ-2PL
-ty-ee	-SUBJ-PRES
-ty-aa	-SUBJ-2SG
-ty-im	-SUBJ-1SG
-tiy-im	-SUBJ-1SG
-ty-im-aa	-SUBJ-1SG-REM
-ty-in	-SUBJ-1PL
-ty-ind	-SUBJ-3PL
-ty-ir	-SUBJ-3SG
-ty-er	-SUBJ-3SG
-ty-ir-is	-SUBJ-3SG-3SG
-ty-is	-SUBJ-2PL
-č	-SUBJ
-č-aa	-SUBJ-2SG
-č-im	-SUBJ-1SG
-č-im-aa	-SUBJ-1SG-REM
-č-in	-SUBJ-1PL
-č-ind	-SUBJ-3PL
-č-ir	-SUBJ-3SG
-č-er	-SUBJ-3SG
-č-ir-is	-SUBJ-3SG-3SG
-č-is	-SUBJ-2PL
-čč	-SUBJ
-čč-aa	-SUBJ-2SG
-čč-im	-SUBJ-1SG
-čč-in	-SUBJ-1PL
-čč-ind	-SUBJ-3PL
-čč-ir	-SUBJ-3SG
-čč-is	-SUBJ-2PL
-čč-r-is	-SUBJ-3SG-3SG


-r-à	-PFV-3SG
-r-aa	-PFV-REM
-r-ee	-PFV-PRES
-r-een	-PFV-1PL
-r-een-aa	-PFV-1PL-REM
-r-een-ee	-PFV-1PL-PRES
-r-een-ir	-PFV-1PL-2SG
-r-een-ir-aa	-PFV-1PL-2SG-REM
-r-een-ir-ee	-PFV-1PL-2SG-PRES
-r-een-iraa	-PFV-1PL-2PL
-r-een-iraan	-PFV-1PL-2PL
-r-een-iraan-aa	-PFV-1PL-2PL-REM
-r-een-iraan-ee	-PFV-1PL-2PL-PRES
-r-een-is	-PFV-1PL-3SG
-r-een-is-aa	-PFV-1PL-3SG-REM
-r-een-is-ee	-PFV-1PL-3SG-PRES
-r-een-isaa	-PFV-1PL-3PL
-r-een-isaan	-PFV-1PL-3PL
-r-een-isaan-aa	-PFV-1PL-3PL-REM
-r-een-isaan-ee	-PFV-1PL-3PL-PRES
-r-eend	-PFV-3PL
-r-eend-aa	-PFV-3PL-REM
-r-eend-à	-PFV-3PL-REM
-r-eend-ee	-PFV-3PL-PRES
-r-eend-im	-PFV-3PL-1SG
-r-eend-im-aa	-PFV-3PL-1SG-REM
-r-eend-im-ee	-PFV-3PL-1SG-PRES
-r-eend-imaa	-PFV-3PL-1PL
-r-eend-imaan	-PFV-3PL-1PL
-r-eend-imaan-aa	-PFV-3PL-1PL-REM
-r-eend-imaan-ee	-PFV-3PL-1PL-PRES
-r-eend-ir	-PFV-3PL-2SG
-r-eend-ir-aa	-PFV-3PL-2SG-REM
-r-eend-ir-ee	-PFV-3PL-2SG-PRES
-r-eend-iraa	-PFV-3PL-2PL
-r-eend-iraan	-PFV-3PL-2PL
-r-eend-iraan-aa	-PFV-3PL-2PL-REM
-r-eend-iraan-ee	-PFV-3PL-2PL-PRES
-r-eend-is	-PFV-3PL-3SG
-r-eend-is-aa	-PFV-3PL-3SG-REM
-r-eend-is-ee	-PFV-3PL-3SG-PRES
-r-eend-isaa	-PFV-3PL-3PL
-r-eend-isaan	-PFV-3PL-3PL
-r-eend-isaan-aa	-PFV-3PL-3PL-REM
-r-eend-isaan-ee	-PFV-3PL-3PL-PRES
-r-ees	-PFV-2PL
-r-ees-aa	-PFV-2PL-REM
-r-ees-ee	-PFV-2PL-PRES
-r-ees-im	-PFV-2PL-1SG
-r-ees-im-aa	-PFV-2PL-1SG-REM
-r-ees-im-ee	-PFV-2PL-1SG-PRES
-r-ees-imaa	-PFV-2PL-1PL
-r-ees-imaan	-PFV-2PL-1PL
-r-ees-imaan-aa	-PFV-2PL-1PL-REM
-r-ees-imaan-ee	-PFV-2PL-1PL-PRES
-r-ees-iraa	-PFV-2PL-2PL
-r-ees-iraan	-PFV-2PL-1PL
-r-ees-iraan-aa	-PFV-2PL-1PL-REM
-r-ees-iraan-ee	-PFV-2PL-1PL-PRES
-r-ees-is	-PFV-2PL-3SG
-r-ees-is-aa	-PFV-2PL-3SG-REM
-r-ees-is-ee	-PFV-2PL-3SG-PRES
-r-om	-PFV-1SG
-r-om-aa	-PFV-1SG-REM
-r-om-ee	-PFV-1SG-PRES
-r-om-ir	-PFV-1SG-2SG
-r-om-ir-aa	-PFV-1SG-2SG-REM
-r-om-ir-ee	-PFV-1SG-2SG-PRES
-r-om-iraa	-PFV-1SG-2PL
-r-om-iraan	-PFV-1SG-2PL
-r-om-iraan-aa	-PFV-1SG-2PL-REM
-r-om-iraan-ee	-PFV-1SG-2PL-PRES
-r-om-is	-PFV-1SG-3SG
-r-om-is-aa	-PFV-1SG-3SG-REM
-r-om-is-ee	-PFV-1SG-3SG-PRES
-r-om-isaa	-PFV-1SG-3PL
-r-om-isaan	-PFV-1SG-3PL
-r-om-isaan-aa	-PFV-1SG-3PL-REM
-r-om-isaan-ee	-PFV-1SG-3PL-PRES
-r-or	-PFV-2SG
-r-or-ee	-PFV-2SG-PRES
-r-or-im	-PFV-2SG-1SG
-r-or-im-aa	-PFV-2SG-1SG-REM
-r-or-im-ee	-PFV-2SG-1SG-PRES
-r-or-imaa	-PFV-2SG-1PL
-r-or-imaan	-PFV-2SG-1PL
-r-or-imaan-aa	-PFV-2SG-1PL-REM
-r-or-imaan-ee	-PFV-2SG-1PL-PRES
-r-or-is	-PFV-2SG-3SG
-r-or-is-aa	-PFV-2SG-3SG-REM
-r-or-is-ee	-PFV-2SG-3SG-PRES
-r-or-isaa	-PFV-2SG-3PL
-r-or-isaan	-PFV-2SG-3PL
-r-or-isaan-aa	-PFV-2SG-3PL-REM
-r-or-isaan-ee	-PFV-2SG-3PL-PRES
-r-os	-PFV-3SG
-r-os-im	-PFV-3SG-1SG
-r-os-im-aa	-PFV-3SG-1SG-REM
-r-os-im-ee	-PFV-3SG-1SG-PRES
-r-os-imaa	-PFV-3SG-1PL
-r-os-imaan	-PFV-3SG-1PL
-r-os-imaan-aa	-PFV-3SG-1PL-REM
-r-os-imaan-ee	-PFV-3SG-1PL-PRES
-r-os-ir	-PFV-3SG-2SG
-r-os-ir-aa	-PFV-3SG-2SG-REM
-r-os-ir-ee	-PFV-3SG-2SG-PRES
-r-os-iraa	-PFV-3SG-2PL
-r-os-iraan	-PFV-3SG-2PL
-r-os-iraan-aa	-PFV-3SG-2PL-REM
-r-os-iraan-ee	-PFV-3SG-2PL-PRES
-r-os-is	-PFV-3SG-3SG
-r-os-is-aa	-PFV-3SG-3SG-REM
-r-os-is-ee	-PFV-3SG-3SG-PRES
-r-os-isaa	-PFV-3SG-3PL
-r-os-isaan	-PFV-3SG-3PL
-r-os-isaan-aa	-PFV-3SG-3PL-REM
-r-os-isaan-ee	-PFV-3SG-3PL-PRES
-r-os-s	-PFV-3SG-3SG
-r-os-s-aa	-PFV-3SG-3SG-REM
-r-os-s-ee	-PFV-3SG-3SG-PRES
-r-os-san	-PFV-3SG-3PL
-d-à	-PFV-3SG
-d-aa	-PFV-REM
-d-ee	-PFV-PRES
-d-een	-PFV-1PL
-d-een-aa	-PFV-1PL-REM
-d-een-ee	-PFV-1PL-PRES
-d-een-ir	-PFV-1PL-2SG
-d-een-ir-aa	-PFV-1PL-2SG-REM
-d-een-ir-ee	-PFV-1PL-2SG-PRES
-d-een-iraa	-PFV-1PL-2PL
-d-een-iraan	-PFV-1PL-2PL
-d-een-iraan-aa	-PFV-1PL-2PL-REM
-d-een-iraan-ee	-PFV-1PL-2PL-PRES
-d-een-is	-PFV-1PL-3SG
-d-een-is-aa	-PFV-1PL-3SG-REM
-d-een-is-ee	-PFV-1PL-3SG-PRES
-d-een-isaa	-PFV-1PL-3PL
-d-een-isaan	-PFV-1PL-3PL
-d-een-isaan-aa	-PFV-1PL-3PL-REM
-d-een-isaan-ee	-PFV-1PL-3PL-PRES
-d-een-saan-ee	-PFV-1PL-3PL-PRES
-d-een-saan-aa	-PFV-1PL-3PL-REM
-d-een-saan	-PFV-1PL-3PL
-d-eend	-PFV-3PL
-d-eend-aa	-PFV-3PL-REM
-d-eend-à	-PFV-3PL-REM
-d-eend-ee	-PFV-3PL-PRES
-d-eend-im	-PFV-3PL-1SG
-d-eend-im-aa	-PFV-3PL-1SG-REM
-d-eend-im-ee	-PFV-3PL-1SG-PRES
-d-eend-imaa	-PFV-3PL-1PL
-d-eend-imaan	-PFV-3PL-1PL
-d-eend-imaan-aa	-PFV-3PL-1PL-REM
-d-eend-imaan-ee	-PFV-3PL-1PL-PRES
-d-eend-ir	-PFV-3PL-2SG
-d-eend-ir-aa	-PFV-3PL-2SG-REM
-d-eend-ir-ee	-PFV-3PL-2SG-PRES
-d-eend-iraa	-PFV-3PL-2PL
-d-eend-iraan	-PFV-3PL-2PL
-d-eend-iraan-aa	-PFV-3PL-2PL-REM
-d-eend-iraan-ee	-PFV-3PL-2PL-PRES
-d-eend-is	-PFV-3PL-3SG
-d-eend-is-aa	-PFV-3PL-3SG-REM
-d-eend-is-ee	-PFV-3PL-3SG-PRES
-d-eend-isaa	-PFV-3PL-3PL
-d-eend-isaan	-PFV-3PL-3PL
-eend-isaa	-3PL-3PL
-d-eend-isaan-aa	-PFV-3PL-3PL-REM
-d-eend-isaan-ee	-PFV-3PL-3PL-PRES
-d-ees	-PFV-2PL
-d-ees-aa	-PFV-2PL-REM
-d-ees-ee	-PFV-2PL-PRES
-d-ees-im	-PFV-2PL-1SG
-d-ees-im-aa	-PFV-2PL-1SG-REM
-d-ees-im-ee	-PFV-2PL-1SG-PRES
-d-ees-imaa	-PFV-2PL-1PL
-d-ees-imaan	-PFV-2PL-1PL
-d-ees-imaan-aa	-PFV-2PL-1PL-REM
-d-ees-imaan-ee	-PFV-2PL-1PL-PRES
-d-ees-iraa	-PFV-2PL-2PL
-d-ees-iraan	-PFV-2PL-1PL
-d-ees-iraan-aa	-PFV-2PL-1PL-REM
-d-ees-iraan-ee	-PFV-2PL-1PL-PRES
-d-ees-is	-PFV-2PL-3SG
-d-ees-is-aa	-PFV-2PL-3SG-REM
-d-ees-is-ee	-PFV-2PL-3SG-PRES
-d-om	-PFV-1SG
-d-om-aa	-PFV-1SG-REM
-d-om-ee	-PFV-1SG-PRES
-d-om-ir	-PFV-1SG-2SG
-d-om-ir-aa	-PFV-1SG-2SG-REM
-d-om-ir-ee	-PFV-1SG-2SG-PRES
-d-om-iraa	-PFV-1SG-2PL
-d-om-iraan	-PFV-1SG-2PL
-d-om-iraan-aa	-PFV-1SG-2PL-REM
-d-om-iraan-ee	-PFV-1SG-2PL-PRES
-d-om-is	-PFV-1SG-3SG
-d-om-is-aa	-PFV-1SG-3SG-REM
-d-om-is-ee	-PFV-1SG-3SG-PRES
-d-om-isaa	-PFV-1SG-3PL
-d-om-isaan	-PFV-1SG-3PL
-d-om-isaan-aa	-PFV-1SG-3PL-REM
-d-om-isaan-ee	-PFV-1SG-3PL-PRES
-d-or	-PFV-2SG
-d-or-ee	-PFV-2SG-PRES
-d-or-aa	-PFV-2SG-REM
-d-or-im	-PFV-2SG-1SG
-d-or-im-aa	-PFV-2SG-1SG-REM
-d-or-im-ee	-PFV-2SG-1SG-PRES
-d-or-imaa	-PFV-2SG-1PL
-d-or-imaan	-PFV-2SG-1PL
-d-or-imaan-aa	-PFV-2SG-1PL-REM
-d-or-imaan-ee	-PFV-2SG-1PL-PRES
-d-or-is	-PFV-2SG-3SG
-d-or-is-aa	-PFV-2SG-3SG-REM
-d-or-is-ee	-PFV-2SG-3SG-PRES
-d-or-isaa	-PFV-2SG-3PL
-d-or-isaan	-PFV-2SG-3PL
-d-or-isaan-aa	-PFV-2SG-3PL-REM
-d-or-isaan-ee	-PFV-2SG-3PL-PRES
-d-os	-PFV-3SG
-d-os-im	-PFV-3SG-1SG
-d-os-im-aa	-PFV-3SG-1SG-REM
-d-os-im-ee	-PFV-3SG-1SG-PRES
-d-os-imaa	-PFV-3SG-1PL
-d-os-imaan	-PFV-3SG-1PL
-d-os-imaan-aa	-PFV-3SG-1PL-REM
-d-os-imaan-ee	-PFV-3SG-1PL-PRES
-d-os-ir	-PFV-3SG-2SG
-d-os-ir-aa	-PFV-3SG-2SG-REM
-d-os-ir-ee	-PFV-3SG-2SG-PRES
-d-os-iraa	-PFV-3SG-2PL
-d-os-iraan	-PFV-3SG-2PL
-d-os-iraan-aa	-PFV-3SG-2PL-REM
-d-os-iraan-ee	-PFV-3SG-2PL-PRES
-d-os-is	-PFV-3SG-3SG
-d-os-is-aa	-PFV-3SG-3SG-REM
-d-os-is-ee	-PFV-3SG-3SG-PRES
-d-os-isaa	-PFV-3SG-3PL
-d-os-isaan	-PFV-3SG-3PL
-d-os-isaan-aa	-PFV-3SG-3PL-REM
-d-os-isaan-ee	-PFV-3SG-3PL-PRES
-d-os-s	-PFV-3SG-3SG
-d-os-saa	-PFV-3SG-3PL
-os-saan	-3SG-3PL
-os-saan-ee	-3SG-3PL-PRES
-os-saan-aa	-3SG-3PL-REM
-d-os-s-aa	-PFV-3SG-3SG-REM
-d-os-s-ee	-PFV-3SG-3SG-PRES
-d-os-san	-PFV-3SG-3PL
-ee	-PRES/2SG.PRES/PL
-ee-m	-PL-1SG
-ee-maa	-PL-1PL
-ee-maan	-PL-1PL
-ee-r	-PL-2SG
-ee-raa	-PL-2PL
-ee-raan	-PL-2PL
-ee-s	-PL-3SG
-ee-saa	-PL-3PL
-ee-saan	-PL-3PL
-een	-DEF
-een-mà	-DEF-LOC
-een-m-aa	-DEF-LOC-REM
-een-tà	-DEF-DAT
-een-t-aa	-DEF-DAT-REM
-een-kii	-DEF-ABL
-ees	-OBL.SG
-h	-VITR
-h-r-à	-VITR-PFV-3SG
-h-r-een	-VITR-PFV-1PL
-h-r-eend	-VITR-PFV-3PL
-h-r-ees	-VITR-PFV-2PL
-h-r-om	-VITR-PFV-1SG
-h-r-or	-VITR-PFV-2SG
-ho	-VITR
-ho-m-ee	-VITR-1SG-PRES
-ho-n-ee	-VITR-1PL-PRES
-ho-nd-ee	-VITR-3PL-PRES
-ho-r-ee	-VITR-3SG-PRES
-ho-s-ee	-VITR-2PL-PRES
-ho-w-ee	-VITR-2SG-PRES
-i	-OBL.SG
-ičč-aa	-SUBJ-2SG
-ičč-im	-SUBJ-1SG
-ičč-in	-SUBJ-1PL
-ičč-ind	-SUBJ-3PL
-ičč-ir	-SUBJ-3SG
-ičč-is	-SUBJ-2PL
-id-or-aa	-PFV-2SG-REM
-ii	-F/3SG/2SG.PRES/2SG.IMP
-ii-r-à	-VITR-PFV-3SG
-ii-r-aa	-VITR-PFV-REM
-ii-r-ee	-VITR-PFV-PRES
-ii-r-een	-VITR-PFV-1PL
-ii-r-eend	-VITR-PFV-3PL
-ii-r-ees	-VITR-PFV-2PL
-ii-r-om	-VITR-PFV-1SG
-ii-r-or	-VITR-PFV-2SG
-ii-r-een-ee	-VITR-PFV-1PL-PRES
-ii-r-eend-ee	-VITR-PFV-3PL-PRES
-ii-r-ees-ee	-VITR-PFV-2PL-PRES
-ii-r-om-ee	-VITR-PFV-1SG-PRES
-ii-r-or-ee	-VITR-PFV-2SG-PRES
-ii-r-een-aa	-VITR-PFV-1PL-REM
-ii-r-eend-aa	-VITR-PFV-3PL-REM
-ii-r-ees-aa	-VITR-PFV-2PL-REM
-ii-r-om-aa	-VITR-PFV-1SG-REM
-ii-r-or-aa	-VITR-PFV-2SG-REM
-iin	-PL
-iiin	-PL
-iiš	-DER
-ika	-with/-DIR
-ikaa	-DIR
-ikee	-DIR
-ikkee	-DIR
-kkee	-DIR
-ikeeree	-BEN
-ikeer	-BEN
-ikii	-ABL
-im	-1SG/LOC
-im-aa	-1SG-REM
-im-ee	-1SG-PRES
-im-ir-aa	-1SG-2SG-REM
-im-ir-ee	-1SG-2SG-PRES
-im-iraan-aa	-1SG-2PL-REM
-im-iraan-ee	-1SG-2PL-PRES
-im-is-aa	-1SG-3SG-REM
-im-is-ee	-1SG-3SG-PRES
-im-isaan-aa	-1SG-3PL-REM
-im-isaan-ee	-1SG-3PL-PRES
-im-r-aa	-1SG-2SG-REM
-im-r-ee	-1SG-2SG-PRES
-im-raan-aa	-1SG-2PL-REM
-im-raan-ee	-1SG-2PL-PRES
-im-s-aa	-1SG-3SG-REM
-im-s-ee	-1SG-3SG-PRES
-im-saan-aa	-1SG-3PL-REM
-im-saan-ee	-1SG-3PL-PRES
-m-aa	-1SG-REM
-m-ee	-1SG-PRES
-m-ir-aa	-1SG-2SG-REM
-m-ir-ee	-1SG-2SG-PRES
-m-iraan-aa	-1SG-2PL-REM
-m-iraan-ee	-1SG-2PL-PRES
-m-is-aa	-1SG-3SG-REM
-m-is-ee	-1SG-3SG-PRES
-m-isaan-aa	-1SG-3PL-REM
-m-isaan-ee	-1SG-3PL-PRES
-m-r-aa	-1SG-2SG-REM
-m-r-ee	-1SG-2SG-PRES
-m-raan-aa	-1SG-2PL-REM
-m-raan-ee	-1SG-2PL-PRES
-m-s-aa	-1SG-3SG-REM
-m-s-ee	-1SG-3SG-PRES
-m-saan-aa	-1SG-3PL-REM
-m-saan-ee	-1SG-3PL-PRES
-imà	-LOC
-imaan	-1PL
-in	-1PL/NEG/OBL.PL/DEF
-in-	-NEG-
-ni-	-NEG-
in-	NEG-
nin-	NEG-
nin-yee	NEG-PRES
inn-	NEG-
inn-ee	NEG-PRES
inn-aa	NEG-REM
-in-aa	-1PL-REM
-in-ee	-1PL-PRES
-in-kar-d-een-ir	-NEG-VTR-PFV-1PL-2SG
-in-kar-d-een-ir-aa	-NEG-PFV-1PL-2SG-REM
-in-kar-d-een-ir-ee	-NEG-PFV-1PL-2SG-PRES
-in-kar-d-een-iraa	-NEG-VTR-PFV-1PL-2PL
-in-kar-d-een-iraan	-NEG-VTR-PFV-1PL-2PL
-in-kar-d-een-iraan-aa	-NEG-PFV-1PL-2PL-REM
-in-kar-d-een-iraan-ee	-NEG-PFV-1PL-2PL-PRES
-in-kar-d-een-is	-NEG-VTR-PFV-1PL-3SG
-in-kar-d-een-is-aa	-NEG-PFV-1PL-3SG-REM
-in-kar-d-een-is-ee	-NEG-PFV-1PL-3SG-PRES
-in-kar-d-een-isaa	-NEG-VTR-PFV-1PL-3PL
-in-kar-d-een-isaan	-NEG-VTR-PFV-1PL-3PL
-in-kar-d-een-isaan-aa	-NEG-PFV-1PL-3PL-REM
-in-kar-d-een-isaan-ee	-NEG-PFV-1PL-3PL-PRES
-in-kar-d-eend-im	-NEG-VTR-PFV-3PL-1SG
-in-kar-d-eend-im-aa	-NEG-PFV-3PL-1SG-REM
-in-kar-d-eend-im-ee	-NEG-PFV-3PL-1SG-PRES
-in-kar-d-eend-imaa	-NEG-VTR-PFV-3PL-1PL
-in-kar-d-eend-imaan	-NEG-VTR-PFV-3PL-1PL
-in-kar-d-eend-imaan-aa	-NEG-PFV-3PL-1PL-REM
-in-kar-d-eend-imaan-ee	-NEG-PFV-3PL-1PL-PRES
-in-kar-d-eend-ir	-NEG-VTR-PFV-3PL-2SG
-in-kar-d-eend-ir-aa	-NEG-PFV-3PL-2SG-REM
-in-kar-d-eend-ir-ee	-NEG-PFV-3PL-2SG-PRES
-in-kar-d-eend-iraa	-NEG-VTR-PFV-3PL-2PL
-in-kar-d-eend-iraan	-NEG-VTR-PFV-3PL-2PL
-in-kar-d-eend-iraan-aa	-NEG-PFV-3PL-2PL-REM
-in-kar-d-eend-iraan-ee	-NEG-PFV-3PL-2PL-PRES
-in-kar-d-eend-is	-NEG-VTR-PFV-3PL-3SG
-in-kar-d-eend-is-aa	-NEG-PFV-3PL-3SG-REM
-in-kar-d-eend-is-ee	-NEG-PFV-3PL-3SG-PRES
-in-kar-d-eend-isaa	-NEG-VTR-PFV-3PL-3PL
-in-kar-d-eend-isaan	-NEG-VTR-PFV-3PL-3PL
-in-kar-d-eend-isaan-aa	-NEG-PFV-3PL-3PL-REM
-in-kar-d-eend-isaan-ee	-NEG-PFV-3PL-3PL-PRES
-in-kar-d-ees-im	-NEG-VTR-PFV-2PL-1SG
-in-kar-d-ees-im-aa	-NEG-PFV-2PL-1SG-REM
-in-kar-d-ees-im-ee	-NEG-PFV-2PL-1SG-PRES
-in-kar-d-ees-imaa	-NEG-VTR-PFV-2PL-1PL
-in-kar-d-ees-imaan	-NEG-VTR-PFV-2PL-1PL
-in-kar-d-ees-imaan-aa	-NEG-PFV-2PL-1PL-REM
-in-kar-d-ees-imaan-ee	-NEG-PFV-2PL-1PL-PRES
-in-kar-d-ees-iraa	-NEG-VTR-PFV-2PL-2PL
-in-kar-d-ees-iraan	-NEG-VTR-PFV-2PL-1PL
-in-kar-d-ees-iraan-aa	-NEG-PFV-2PL-1PL-REM
-in-kar-d-ees-iraan-ee	-NEG-PFV-2PL-1PL-PRES
-in-kar-d-ees-is	-NEG-VTR-PFV-2PL-3SG
-in-kar-d-ees-is-aa	-NEG-PFV-2PL-3SG-REM
-in-kar-d-ees-is-ee	-NEG-PFV-2PL-3SG-PRES
-in-kar-d-om-ir	-NEG-VTR-PFV-1SG-2SG
-in-kar-d-om-ir-aa	-NEG-PFV-1SG-2SG-REM
-in-kar-d-om-ir-ee	-NEG-VTR-PFV-1SG-2SG-PRES
-in-kar-d-om-iraa	-NEG-VTR-PFV-1SG-2PL
-in-kar-d-om-iraan	-NEG-VTR-PFV-1SG-2PL
-in-kar-d-om-iraan-aa	-NEG-PFV-1SG-2PL-REM
-in-kar-d-om-iraan-ee	-NEG-VTR-PFV-1SG-2PL-PRES
-in-kar-d-om-is	-NEG-VTR-PFV-1SG-3SG
-in-kar-d-om-is-aa	-NEG-PFV-1SG-3SG-REM
-in-kar-d-om-is-ee	-NEG-VTR-PFV-1SG-3SG-PRES
-in-kar-d-om-isaa	-NEG-VTR-PFV-1SG-3PL
-in-kar-d-om-isaan	-NEG-VTR-PFV-1SG-3PL
-in-kar-d-om-isaan-aa	-NEG-PFV-1SG-3PL-REM
-in-kar-d-om-isaan-ee	-NEG-VTR-PFV-1SG-3PL-PRES
-in-kar-d-or-im	-NEG-VTR-PFV-2SG-1SG
-in-kar-d-or-im-aa	-NEG-PFV-2SG-1SG-REM
-in-kar-d-or-im-ee	-NEG-VTR-PFV-2SG-1SG-PRES
-in-kar-d-or-imaa	-NEG-VTR-PFV-2SG-1PL
-in-kar-d-or-imaan	-NEG-VTR-PFV-2SG-1PL
-in-kar-d-or-imaan-aa	-NEG-PFV-2SG-1PL-REM
-in-kar-d-or-imaan-ee	-NEG-PFV-2SG-1PL-PRES
-in-kar-d-or-is	-NEG-VTR-PFV-2SG-3SG
-in-kar-d-or-is-aa	-NEG-PFV-2SG-3SG-REM
-in-kar-d-or-is-ee	-NEG-VTR-PFV-2SG-3SG-PRES
-in-kar-d-or-isaa	-NEG-VTR-PFV-2SG-3PL
-in-kar-d-or-isaan	-NEG-VTR-PFV-2SG-3PL
-in-kar-d-or-isaan-aa	-NEG-PFV-2SG-3PL-REM
-in-kar-d-or-isaan-ee	-NEG-PFV-2SG-3PL-PRES
-in-kar-d-os-im	-NEG-VTR-PFV-3SG-1SG
-in-kar-d-os-im-aa	-NEG-PFV-3SG-1SG-REM
-in-kar-d-os-im-ee	-NEG-VTR-PFV-3SG-1SG-PRES
-in-kar-d-os-imaa	-NEG-VTR-PFV-3SG-1PL
-in-kar-d-os-imaan	-NEG-VTR-PFV-3SG-1PL
-in-kar-d-os-imaan-aa	-NEG-PFV-3SG-1PL-REM
-in-kar-d-os-imaan-ee	-NEG-VTR-PFV-3SG-1PL-PRES
-in-kar-d-os-ir	-NEG-VTR-PFV-3SG-2SG
-in-kar-d-os-ir-aa	-NEG-PFV-3SG-2SG-REM
-in-kar-d-os-ir-ee	-NEG-VTR-PFV-3SG-2SG-PRES
-in-kar-d-os-iraa	-NEG-VTR-PFV-3SG-2PL
-in-kar-d-os-iraan	-NEG-VTR-PFV-3SG-2PL
-in-kar-d-os-iraan-aa	-NEG-PFV-3SG-2PL-REM
-in-kar-d-os-iraan-ee	-NEG-VTR-PFV-3SG-2PL-PRES
-in-kar-d-os-is	-NEG-VTR-PFV-3SG-3SG
-in-kar-d-os-is-aa	-NEG-PFV-3SG-3SG-REM
-in-kar-d-os-is-ee	-NEG-VTR-PFV-3SG-3SG-PRES
-in-kar-d-os-isaa	-NEG-VTR-PFV-3SG-3PL
-in-kar-d-os-isaan	-NEG-VTR-PFV-3SG-3PL
-in-kar-d-os-isaan-aa	-NEG-PFV-3SG-3PL-REM
-in-kar-d-os-isaan-ee	-NEG-VTR-PFV-3SG-3PL-PRES
-in-kar-d-os-s	-NEG-VTR-PFV-3SG-3SG
-in-kar-d-os-s-ee	-NEG-VTR-PFV-3SG-3SG-PRES
-in-kar-d-os-san	-NEG-VTR-PFV-3SG-3PL
-in-kar-d-os-san-aa	-NEG-VTR-PFV-3SG-3PL-REM
-in-kar-d-os-san-ee	-NEG-VTR-PFV-3SG-3PL-PRES
-in-keerà	-OBL.PL-BEN
-in-keeree	-OBL.PL-BEN
-in-kii	-OBL.PL-ABL
-in-kee	-OBL.PL-DIR
-in-mà	-OBL.PL-LOC
-in-tà	-OBL.PL-DAT
-ind	-3PL
-iind	-3PL
-ind-aa	-3PL-REM
-ind-ee	-3PL-PRES
-ind-im	-3PL-1SG
-ind-im-aa	-3PL-1SG-REM
-ind-im-ee	-3PL-1SG-PRES
-ind-imaa	-3PL-1PL
-ind-imaan	-3PL-1PL
-ind-imaan-aa	-3PL-1PL-REM
-ind-imaan-ee	-3PL-1PL-PRES
-ind-ir	-3PL-2SG
-ind-ir-aa	-3PL-2SG-REM
-ind-ir-ee	-3PL-2SG-PRES
-ind-iraa	-3PL-2PL
-ind-iraan	-3PL-2PL
-ind-iraan-aa	-3PL-2PL-REM
-ind-iraan-ee	-3PL-2PL-PRES
-ind-is	-3PL-3SG
-ind-is-aa	-3PL-3SG-REM
-ind-s-aa	-3PL-3SG-REM
-ind-is-ee	-3PL-3SG-PRES
-ind-isaa	-3PL-3PL
-ind-isaan	-3PL-3PL
-ind-isaan-aa	-3PL-3PL-REM
-ind-isaan-ee	-3PL-3PL-PRES
-nd-aa	-3PL-REM
-nd-ee	-3PL-PRES
-nd-im	-3PL-1SG
-nd-im-aa	-3PL-1SG-REM
-nd-im-ee	-3PL-1SG-PRES
-nd-imaa	-3PL-1PL
-nd-imaan	-3PL-1PL
-nd-imaan-aa	-3PL-1PL-REM
-nd-imaan-ee	-3PL-1PL-PRES
-nd-ir	-3PL-2SG
-nd-ir-aa	-3PL-2SG-REM
-nd-ir-ee	-3PL-2SG-PRES
-nd-iraa	-3PL-2PL
-nd-iraan	-3PL-2PL
-nd-iraan-aa	-3PL-2PL-REM
-nd-iraan-ee	-3PL-2PL-PRES
-nd-is	-3PL-3SG
-nd-is-aa	-3PL-3SG-REM
-nd-s-aa	-3PL-3SG-REM
-nd-is-ee	-3PL-3SG-PRES
-nd-isaa	-3PL-3PL
-nd-isaan	-3PL-3PL
-nd-isaan-aa	-3PL-3PL-REM
-nd-isaan-ee	-3PL-3PL-PRES
-ir	-2SG/3SG
-ir-à	-PFV-3SG
-ir-aa	-3SG-REM/-PFV-REM
-ir-ee	-3SG-PRES
-ir-een	-PFV-1PL
-ir-een-aa	-PFV-1PL-REM
-ir-een-ee	-PFV-1PL-PRES
-ir-eend	-PFV-3PL
-ir-eend-aa	-PFV-3PL-REM
-ir-eend-ee	-PFV-3PL-PRES
-ir-ees	-PFV-2PL
-ir-ees-aa	-PFV-2PL-REM
-ir-ees-ee	-PFV-2PL-PRES
-ir-im	-3SG-1SG
-ir-im-aa	-3SG-1SG-REM
-ir-im-ee	-3SG-1SG-PRES
-ir-imaa	-3SG-1PL
-ir-imaan	-3SG-1PL
-ir-imaan-aa	-3SG-1PL-REM
-ir-imaan-ee	-3SG-1PL-PRES
-ir-ir	-3SG-2SG
-ir-ir-aa	-3SG-2SG-REM
-ir-ir-ee	-3SG-2SG-PRES
-ir-iraa	-3SG-2PL
-ir-iraan	-3SG-2PL
-ir-iraan-aa	-3SG-2PL-REM
-ir-iraan-ee	-3SG-2PL-PRES
-ir-is	-3SG-3SG
-ir-is-aa	-3SG-3SG-REM
-ir-is-ee	-3SG-3SG-PRES
-ir-isaa	-3SG-3PL
-ir-isaan	-3SG-3PL
-ir-isaan-aa	-3SG-3PL-REM
-ir-isaan-ee	-3SG-3PL-PRES
-ir-m-aa	-3SG-1SG-REM
-ir-m-ee	-3SG-1SG-PRES
-ir-maan-aa	-3SG-1PL-REM
-ir-maan-ee	-3SG-1PL-PRES
-ir-om	-PFV-1SG
-ir-om-aa	-PFV-1SG-REM
-ir-om-ee	-PFV-1SG-PRES
-ir-or	-PFV-2SG
-ir-or-aa	-PFV-2SG-REM
-ir-or-ee	-PFV-2SG-PRES
-ir-os	-PFV-3SG
-ir-os-ee	-PFV-3SG-PRES
-ir-r-aa	-3SG-2SG-REM
-ir-r-ee	-3SG-2SG-PRES
-ir-raan-aa	-3SG-2PL-REM
-ir-raan-ee	-3SG-2PL-PRES
-ir-s-aa	-3SG-3SG-REM
-ir-s-ee	-3SG-3SG-PRES
-ir-saan	-3SG-3PL
-ir-saan-aa	-3SG-3PL-REM
-ir-saan-ee	-3SG-3PL-PRES
-iraan	-2PL
-ird-à	-PFV-3SG
-ird-aa	-PFV-REM
-ird-ee	-PFV-PRES
-ird-een	-PFV-1PL
-ird-een-aa	-PFV-1PL-REM
-ird-een-ee	-PFV-1PL-PRES
-ird-een-ir	-PFV-1PL-2SG
-ird-een-ir-aa	-PFV-1PL-2SG-REM
-ird-een-ir-ee	-PFV-1PL-2SG-PRES
-ird-een-iraa	-PFV-1PL-2PL
-ird-een-iraan	-PFV-1PL-2PL
-ird-een-iraan-aa	-PFV-1PL-2PL-REM
-ird-een-iraan-ee	-PFV-1PL-2PL-PRES
-ird-een-is	-PFV-1PL-3SG
-ird-een-is-aa	-PFV-1PL-3SG-REM
-ird-een-is-ee	-PFV-1PL-3SG-PRES
-ird-een-s-ee	-PFV-1PL-3SG-PRES
-ird-een-isaa	-PFV-1PL-3PL
-ird-een-isaan	-PFV-1PL-3PL
-ird-een-isaan-aa	-PFV-1PL-3PL-REM
-ird-een-isaan-ee	-PFV-1PL-3PL-PRES
-ird-eend	-PFV-3PL
-ird-eend-aa	-PFV-3PL-REM
-ird-eend-ee	-PFV-3PL-PRES
-ird-eend-im	-PFV-3PL-1SG
-ird-eend-im-aa	-PFV-3PL-1SG-REM
-ird-eend-im-ee	-PFV-3PL-1SG-PRES
-ird-eend-imaa	-PFV-3PL-1PL
-ird-eend-imaan	-PFV-3PL-1PL
-ird-eend-imaan-aa	-PFV-3PL-1PL-REM
-ird-eend-imaan-ee	-PFV-3PL-1PL-PRES
-ird-eend-ir	-PFV-3PL-2SG
-ird-eend-ir-aa	-PFV-3PL-2SG-REM
-ird-eend-ir-ee	-PFV-3PL-2SG-PRES
-ird-eend-iraa	-PFV-3PL-2PL
-ird-eend-iraan	-PFV-3PL-2PL
-ird-eend-iraan-aa	-PFV-3PL-2PL-REM
-ird-eend-iraan-ee	-PFV-3PL-2PL-PRES
-ird-eend-is	-PFV-3PL-3SG
-ird-eend-is-aa	-PFV-3PL-3SG-REM
-ird-eend-is-ee	-PFV-3PL-3SG-PRES
-ird-eend-isaa	-PFV-3PL-3PL
-ird-eend-isaan	-PFV-3PL-3PL
-ird-eend-isaan-aa	-PFV-3PL-3PL-REM
-ird-eend-isaan-ee	-PFV-3PL-3PL-PRES
-ird-ees	-PFV-2PL
-ird-ees-aa	-PFV-2PL-REM
-ird-ees-ee	-PFV-2PL-PRES
-ird-ees-im	-PFV-2PL-1SG
-ird-ees-im-aa	-PFV-2PL-1SG-REM
-ird-ees-im-ee	-PFV-2PL-1SG-PRES
-ird-ees-imaa	-PFV-2PL-1PL
-ird-ees-imaan	-PFV-2PL-1PL
-ird-ees-imaan-aa	-PFV-2PL-1PL-REM
-ird-ees-imaan-ee	-PFV-2PL-1PL-PRES
-ird-ees-iraa	-PFV-2PL-2PL
-ird-ees-iraan	-PFV-2PL-1PL
-ird-ees-iraan-aa	-PFV-2PL-1PL-REM
-ird-ees-iraan-ee	-PFV-2PL-1PL-PRES
-ird-ees-is	-PFV-2PL-3SG
-ird-ees-is-aa	-PFV-2PL-3SG-REM
-ird-ees-is-ee	-PFV-2PL-3SG-PRES
-ird-om	-PFV-1SG
-ird-om-aa	-PFV-1SG-REM
-ird-om-ee	-PFV-1SG-PRES
-ird-om-ir	-PFV-1SG-2SG
-ird-om-ir-aa	-PFV-1SG-2SG-REM
-ird-om-ir-ee	-PFV-1SG-2SG-PRES
-ird-om-iraa	-PFV-1SG-2PL
-ird-om-iraan	-PFV-1SG-2PL
-ird-om-iraan-aa	-PFV-1SG-2PL-REM
-ird-om-iraan-ee	-PFV-1SG-2PL-PRES
-ird-om-is	-PFV-1SG-3SG
-ird-om-is-aa	-PFV-1SG-3SG-REM
-ird-om-is-ee	-PFV-1SG-3SG-PRES
-ird-om-isaa	-PFV-1SG-3PL
-ird-om-isaan	-PFV-1SG-3PL
-ird-om-isaan-aa	-PFV-1SG-3PL-REM
-ird-om-isaan-ee	-PFV-1SG-3PL-PRES
-ird-or	-PFV-2SG
-ird-or-aa	-PFV-2SG-REM
-ird-or-ee	-PFV-2SG-PRES
-ird-or-im	-PFV-2SG-1SG
-ird-or-im-aa	-PFV-2SG-1SG-REM
-ird-or-im-ee	-PFV-2SG-1SG-PRES
-ird-or-imaa	-PFV-2SG-1PL
-ird-or-imaan	-PFV-2SG-1PL
-ird-or-imaan-aa	-PFV-2SG-1PL-REM
-ird-or-imaan-ee	-PFV-2SG-1PL-PRES
-ird-or-is	-PFV-2SG-3SG
-ird-or-is-aa	-PFV-2SG-3SG-REM
-ird-or-is-ee	-PFV-2SG-3SG-PRES
-ird-or-isaa	-PFV-2SG-3PL
-ird-or-isaan	-PFV-2SG-3PL
-ird-or-isaan-aa	-PFV-2SG-3PL-REM
-ird-or-isaan-ee	-PFV-2SG-3PL-PRES
-ird-os	-PFV-3SG
-ird-os-im	-PFV-3SG-1SG
-ird-os-im-aa	-PFV-3SG-1SG-REM
-ird-os-im-ee	-PFV-3SG-1SG-PRES
-ird-os-imaa	-PFV-3SG-1PL
-ird-os-imaan	-PFV-3SG-1PL
-ird-os-imaan-aa	-PFV-3SG-1PL-REM
-ird-os-imaan-ee	-PFV-3SG-1PL-PRES
-ird-os-ir	-PFV-3SG-2SG
-ird-os-ir-aa	-PFV-3SG-2SG-REM
-ird-os-ir-ee	-PFV-3SG-2SG-PRES
-ird-os-iraa	-PFV-3SG-2PL
-ird-os-iraan	-PFV-3SG-2PL
-ird-os-iraan-aa	-PFV-3SG-2PL-REM
-ird-os-iraan-ee	-PFV-3SG-2PL-PRES
-ird-os-is	-PFV-3SG-3SG
-ird-os-is-aa	-PFV-3SG-3SG-REM
-ird-os-is-ee	-PFV-3SG-3SG-PRES
-ird-os-isaa	-PFV-3SG-3PL
-ird-os-isaan	-PFV-3SG-3PL
-ird-os-isaan-aa	-PFV-3SG-3PL-REM
-ird-os-isaan-ee	-PFV-3SG-3PL-PRES
-ird-os-s	-PFV-3SG-3SG
-ird-os-s-aa	-PFV-3SG-3SG-REM
-ird-os-s-ee	-PFV-3SG-3SG-PRES
-is	-3SG/2PL/OBL.SG/2PL.IMP
-iš	-DER
-is-ee	-2PL-PRES
-s-ee	-2PL-PRES
-is-aa	-2PL-REM
-is-m	-3SG-1SG
-is-m-aa	-3SG-1SG-REM
-is-m-ee	-3SG-1SG-PRES
-is-maan	-3SG-1PL
-is-maan-aa	-3SG-1PL-REM
-is-maan-ee	-3SG-1PL-PRES
-is-r	-3SG-2SG
-is-r-aa	-3SG-2SG-REM
-is-r-ee	-3SG-2SG-PRES
-is-raan	-3SG-2PL
-is-raan-aa	-3SG-2PL-REM
-is-raan-ee	-3SG-2PL-PRES
-is-s	-3SG-3SG
-is-s-aa	-3SG-3SG-REM
-is-s-ee	-3SG-3SG-PRES
-is-saan	-3SG-3PL
-is-saan-aa	-3SG-3PL-REM
-is-saan-ee	-3SG-3PL-PRES
-isaa	-SOC/COND/3PL
-isaan	-2PL
-išii	-too
-išš-aa	-SUBJ-2SG
-išš-aa-ee	-SUBJ-2SG-PRES
-išš-im	-SUBJ-1SG
-išš-im-ee	-SUBJ-1SG-PRES
-išš-in	-SUBJ-1PL
-išš-in-ee	-SUBJ-1PL-PRES
-išš-ind	-SUBJ-3PL
-išš-ind-ee	-SUBJ-3PL-PRES
-išš-ir	-SUBJ-3SG
-išš-ir-ee	-SUBJ-3SG-PRES
-išš-is	-SUBJ-2PL
-išš-is-ee	-SUBJ-2PL-PRES
-išt-aa	-COP/PROG-REM
-išt-ee	-COP/PROG-PRES
-išt-im-ir-aa	-PROG-1SG-2SG-REM
-išt-im-ir-ee	-PROG-1SG-2SG-PRES
-išt-im-iraan-aa	-PROG-1SG-2PL-REM
-išt-im-iraan-ee	-PROG-1SG-2PL-PRES
-išt-im-is-aa	-PROG-1SG-3SG-REM
-išt-im-is-ee	-PROG-1SG-3SG-PRES
-išt-im-isaan-aa	-PROG-1SG-3PL-REM
-išt-im-isaan-ee	-PROG-1SG-3PL-PRES
-išt-im-r-aa	-PROG-1SG-2SG-REM
-išt-im-r-ee	-PROG-1SG-2SG-PRES
-išt-im-raan-aa	-PROG-1SG-2PL-REM
-išt-im-raan-ee	-PROG-1SG-2PL-PRES
-išt-im-s-aa	-PROG-1SG-3SG-REM
-išt-im-s-ee	-PROG-1SG-3SG-PRES
-išt-im-saan-aa	-PROG-1SG-3PL-REM
-išt-im-saan-ee	-PROG-1SG-3PL-PRES
-išt-ind	-COP/PROG-3PL
-išt-ind-aa	-COP/PROG-3PL-REM
-išt-ind-ee	-COP/PROG-3PL-PRES
-išt-innd-ee	-COP/PROG-3PL-PRES
-išt-ind-im-aa	-PROG-3PL-1SG-REM
-išt-ind-im-ee	-PROG-3PL-1SG-PRES
-išt-ind-imaan-aa	-PROG-3PL-1PL-REM
-išt-ind-imaan-ee	-PROG-3PL-1PL-PRES
-išt-ind-ir-aa	-PROG-3PL-2SG-REM
-išt-ind-ir-ee	-PROG-3PL-2SG-PRES
-išt-ind-iraan-aa	-PROG-3PL-2PL-REM
-išt-ind-iraan-ee	-PROG-3PL-2PL-PRES
-išt-ind-is-aa	-PROG-3PL-3SG-REM
-išt-ind-is-ee	-PROG-3PL-3SG-PRES
-išt-ind-isaan-aa	-PROG-3PL-3PL-REM
-išt-ind-isaan-ee	-PROG-3PL-3PL-PRES
-išt-inn	-COP/PRGO-1PL
-išt-inn-aa	-COP/PROG-1PL-REM
-išt-inn-ee	-COP/PROG-1PL-PRES
-išt-ir-im-aa	-PROG-3SG-1SG-REM
-išt-ir-im-ee	-PROG-3SG-1SG-PRES
-išt-ir-imaan-aa	-PROG-3SG-1PL-REM
-išt-ir-imaan-ee	-PROG-3SG-1PL-PRES
-išt-ir-ir-aa	-PROG-3SG-2SG-REM
-išt-ir-ir-ee	-PROG-3SG-2SG-PRES
-išt-ir-iraan-aa	-PROG-3SG-2PL-REM
-išt-ir-iraan-ee	-PROG-3SG-2PL-PRES
-išt-ir-is-aa	-PROG-3SG-3SG-REM
-išt-ir-is-ee	-PROG-3SG-3SG-PRES
-išt-ir-isaan-aa	-PROG-3SG-3PL-REM
-išt-ir-isaan-ee	-PROG-3SG-3PL-PRES
-išt-ir-m-aa	-PROG-3SG-1SG-REM
-išt-ir-m-ee	-PROG-3SG-1SG-PRES
-išt-ir-maan-aa	-PROG-3SG-1PL-REM
-išt-ir-maan-ee	-PROG-3SG-1PL-PRES
-išt-ir-r-aa	-PROG-3SG-2SG-REM
-išt-ir-r-ee	-PROG-3SG-2SG-PRES
-išt-ir-raan-aa	-PROG-3SG-2PL-REM
-išt-ir-raan-ee	-PROG-3SG-2PL-PRES
-išt-ir-s-aa	-PROG-3SG-3SG-REM
-išt-ir-s-ee	-PROG-3SG-3SG-PRES
-išt-ir-saan-aa	-PROG-3SG-3PL-REM
-išt-ir-saan-ee	-PROG-3SG-3PL-PRES
-išt-is-m	-PROG-3SG-1SG
-išt-is-m-aa	-PROG-3SG-1SG-REM
-išt-is-m-ee	-PROG-3SG-1SG-PRES
-išt-is-maan	-PROG-3SG-1PL
-išt-is-maan-aa	-PROG-3SG-1PL-REM
-išt-is-maan-ee	-PROG-3SG-1PL-PRES
-išt-is-r	-PROG-3SG-2SG
-išt-is-r-aa	-PROG-3SG-2SG-REM
-išt-is-r-ee	-PROG-3SG-2SG-PRES
-išt-is-raan	-PROG-3SG-2PL
-išt-is-raan-aa	-PROG-3SG-2PL-REM
-išt-is-raan-ee	-PROG-3SG-2PL-PRES
-išt-is-s	-PROG-3SG-3SG
-išt-is-s-aa	-PROG-3SG-3SG-REM
-išt-is-s-ee	-PROG-3SG-3SG-PRES
-išt-is-saan	-PROG-3SG-3PL
-išt-is-saan-aa	-PROG-3SG-3PL-REM
-išt-is-saan-ee	-PROG-3SG-3PL-PRES
-išt-iss	-COP/PROG-2PL
-išt-iss-aa	-COP/PROG-2PL-REM
-išt-iss-ee	-COP/PROG-2PL-PRES
-išt-m-ir-aa	-PROG-1SG-2SG-REM
-išt-m-ir-ee	-PROG-1SG-2SG-PRES
-išt-m-iraan-aa	-PROG-1SG-2PL-REM
-išt-m-iraan-ee	-PROG-1SG-2PL-PRES
-išt-m-is-aa	-PROG-1SG-3SG-REM
-išt-m-is-ee	-PROG-1SG-3SG-PRES
-išt-m-isaan-aa	-PROG-1SG-3PL-REM
-išt-m-isaan-ee	-PROG-1SG-3PL-PRES
-išt-om	-COP/PROG-1SG
-išt-om-aa	-COP/PROG-1SG-REM
-išt-om-ee	-COP/PROG-1SG-PRES
-išt-om-ir-aa	-PROG-1SG-2SG-REM
-išt-om-ir-ee	-PROG-1SG-2SG-PRES
-išt-om-iraan-aa	-PROG-1SG-2PL-REM
-išt-om-iraan-ee	-PROG-1SG-2PL-PRES
-išt-om-is-aa	-PROG-1SG-3SG-REM
-išt-om-is-ee	-PROG-1SG-3SG-PRES
-išt-om-isaan-aa	-PROG-1SG-3PL-REM
-išt-om-isaan-ee	-PROG-1SG-3PL-PRES
-išt-or	-COP/PROG-2SG
-išt-or-aa	-COP/PROG-2SG-REM
-išt-or-ee	-COP/PROG-2SG-PRES
-išt-or-im	-PROG-2SG-1SG
-išt-or-im-aa	-PROG-2SG-1SG-REM
-išt-or-im-ee	-PROG-2SG-1SG-PRES
-išt-or-imaa	-PROG-2SG-1PL
-išt-or-imaan	-PROG-2SG-1PL
-išt-or-imaan-aa	-PROG-2SG-1PL-REM
-išt-or-imaan-ee	-PROG-2SG-1PL-PRES
-išt-or-is	-PROG-2SG-3SG
-išt-or-is-aa	-PROG-2SG-3SG-REM
-išt-or-is-ee	-PROG-2SG-3SG-PRES
-išt-or-isaa	-PROG-2SG-3PL
-išt-or-isaan	-PROG-2SG-3PL
-išt-or-isaan-aa	-PROG-2SG-3PL-REM
-išt-or-isaan-ee	-PROG-2SG-3PL-PRES
-išt-or-m-aa	-PROG-2SG-1SG-REM
-išt-or-m-ee	-PROG-2SG-1SG-PRES
-išt-or-maan-aa	-PROG-2SG-1PL-REM
-išt-or-maan-ee	-PROG-2SG-1PL-PRES
-išt-or-s-aa	-PROG-2SG-3SG-REM
-išt-or-s-ee	-PROG-2SG-3SG-PRES
-išt-or-saan-aa	-PROG-2SG-3PL-REM
-išt-or-saan-ee	-PROG-2SG-3PL-PRES
-išt-r-im-aa	-PROG-3SG-1SG-REM
-išt-r-im-ee	-PROG-3SG-1SG-PRES
-išt-r-imaan-aa	-PROG-3SG-1PL-REM
-išt-r-imaan-ee	-PROG-3SG-1PL-PRES
-išt-r-ir-aa	-PROG-3SG-2SG-REM
-išt-r-ir-ee	-PROG-3SG-2SG-PRES
-išt-r-iraan-aa	-PROG-3SG-2PL-REM
-išt-r-iraan-ee	-PROG-3SG-2PL-PRES
-išt-r-is-aa	-PROG-3SG-3SG-REM
-išt-r-is-ee	-PROG-3SG-3SG-PRES
-išt-r-isaan-aa	-PROG-3SG-3PL-REM
-išt-r-isaan-ee	-PROG-3SG-3PL-PRES
-it	-DAT
-ità	-DAT
-itaa	-DAT
-itee	-DAT
-tee	-DAT
-iva	-VERS
-ivaa	-VERS
-k-r-à	-VTR-PFV-3SG
-k-r-aa	-VTR-PFV-REM
-k-r-ee	-VTR-3SG-PRES/-PFV-PRES
-k-r-een	-VTR-PFV-1PL
-k-r-een-aa	-VTR-PFV-1PL-REM
-k-r-eend	-VTR-PFV-3PL
-k-r-eend-aa	-VTR-PFV-3PL-REM
-k-r-ees	-VTR-PFV-2PL
-k-r-ees-aa	-VTR-PFV-2PL-REM
-k-r-om	-VTR-PFV-1SG
-k-r-om-aa	-VTR-PFV-1SG-REM
-k-r-om-ee	-VTR-PFV-1SG-PRES
-k-r-oom-ee	-VTR-PFV-1SG-PRES
-k-r-or	-VTR-PFV-2SG
-k-r-or-aa	-VTR-PFV-2SG-REM
-k-r-os	-VTR-PFV-3SG
-ka	-FUT/with/DIR
-kà	-DIR
-ka-š-aa-ee	-VTR-PROG-2SG-PRES
-ka-š-im-ee	-VTR-PROG-1SG-PRES
-ka-š-in-ee	-VTR-PROG-1PL-PRES
-ka-š-ind-ee	-VTR-PROG-3PL-PRES
-ka-š-ir-ee	-VTR-PROG-3SG-PRES
-ka-š-is-ee	-VTR-PROG-2PL-PRES
-ka-št	VTR-PROG
-ka-št-aa	-VTR-PROG-REM
-ka-št-ee	-VTR-PROG-PRES
-ka-št-im-ir-aa	-VTR-PROG-1SG-2SG-REM
-ka-št-im-ir-ee	-VTR-PROG-1SG-2SG-PRES
-ka-št-im-iraan-aa	-VTR-PROG-1SG-2PL-REM
-ka-št-im-iraan-ee	-VTR-PROG-1SG-2PL-PRES
-ka-št-im-is-aa	-VTR-PROG-1SG-3SG-REM
-ka-št-im-is-ee	-VTR-PROG-1SG-3SG-PRES
-ka-št-im-isaan-aa	-VTR-PROG-1SG-3PL-REM
-ka-št-im-isaan-ee	-VTR-PROG-1SG-3PL-PRES
-ka-št-im-r-aa	-VTR-PROG-1SG-2SG-REM
-ka-št-im-r-ee	-VTR-PROG-1SG-2SG-PRES
-ka-št-im-raan-aa	-VTR-PROG-1SG-2PL-REM
-ka-št-im-raan-ee	-VTR-PROG-1SG-2PL-PRES
-ka-št-im-s-aa	-VTR-PROG-1SG-3SG-REM
-ka-št-im-s-ee	-VTR-PROG-1SG-3SG-PRES
-ka-št-im-saan-aa	-VTR-PROG-1SG-3PL-REM
-ka-št-im-saan-ee	-VTR-PROG-1SG-3PL-PRES
-ka-št-ind	-VTR-PROG-3PL
-ka-št-ind-aa	-VTR-PROG-3PL-REM
-ka-št-ind-ee	-VTR-PROG-3PL-PRES
-ka-št-ind-im-aa	-VTR-PROG-3PL-1SG-REM
-ka-št-ind-im-ee	-VTR-PROG-3PL-1SG-PRES
-ka-št-ind-imaan-aa	-VTR-PROG-3PL-1PL-REM
-ka-št-ind-imaan-ee	-VTR-PROG-3PL-1PL-PRES
-ka-št-ind-ir-aa	-VTR-PROG-3PL-2SG-REM
-ka-št-ind-ir-ee	-VTR-PROG-3PL-2SG-PRES
-ka-št-ind-iraan-aa	-VTR-PROG-3PL-2PL-REM
-ka-št-ind-iraan-ee	-VTR-PROG-3PL-2PL-PRES
-ka-št-ind-is-aa	-VTR-PROG-3PL-3SG-REM
-ka-št-ind-is-ee	-VTR-PROG-3PL-3SG-PRES
-ka-št-ind-isaan-aa	-VTR-PROG-3PL-3PL-REM
-ka-št-ind-isaan-ee	-VTR-PROG-3PL-3PL-PRES
-ka-št-inn	-VTR-PROG-1PL
-ka-št-inn-aa	-VTR-PROG-1PL-REM
-ka-št-inn-ee	-VTR-PROG-1PL-PRES
-ka-št-ir-im-aa	-VTR-PROG-3SG-1SG-REM
-ka-št-ir-im-ee	-VTR-PROG-3SG-1SG-PRES
-ka-št-ir-imaan-aa	-VTR-PROG-3SG-1PL-REM
-ka-št-ir-imaan-ee	-VTR-PROG-3SG-1PL-PRES
-ka-št-ir-ir-aa	-VTR-PROG-3SG-2SG-REM
-ka-št-ir-ir-ee	-VTR-PROG-3SG-2SG-PRES
-ka-št-ir-iraan-aa	-VTR-PROG-3SG-2PL-REM
-ka-št-ir-iraan-ee	-VTR-PROG-3SG-2PL-PRES
-ka-št-ir-is-aa	-VTR-PROG-3SG-3SG-REM
-ka-št-ir-is-ee	-VTR-PROG-3SG-3SG-PRES
-ka-št-ir-isaan-aa	-VTR-PROG-3SG-3PL-REM
-ka-št-ir-isaan-ee	-VTR-PROG-3SG-3PL-PRES
-ka-št-ir-m-aa	-VTR-PROG-3SG-1SG-REM
-ka-št-ir-m-ee	-VTR-PROG-3SG-1SG-PRES
-ka-št-ir-maan-aa	-VTR-PROG-3SG-1PL-REM
-ka-št-ir-maan-ee	-VTR-PROG-3SG-1PL-PRES
-ka-št-ir-r-aa	-VTR-PROG-3SG-2SG-REM
-ka-št-ir-r-ee	-VTR-PROG-3SG-2SG-PRES
-ka-št-ir-raan-aa	-VTR-PROG-3SG-2PL-REM
-ka-št-ir-raan-ee	-VTR-PROG-3SG-2PL-PRES
-ka-št-ir-s-aa	-VTR-PROG-3SG-3SG-REM
-ka-št-ir-s-ee	-VTR-PROG-3SG-3SG-PRES
-ka-št-ir-saa	-VTR-PROG-3SG-3PL
-ka-št-ir-saan-aa	-VTR-PROG-3SG-3PL-REM
-ka-št-ir-saan-ee	-VTR-PROG-3SG-3PL-PRES
-ka-št-is-m	-VTR-PROG-3SG-1SG
-ka-št-is-m-aa	-VTR-PROG-3SG-1SG-REM
-ka-št-is-m-ee	-VTR-PROG-3SG-1SG-PRES
-ka-št-is-maan	-VTR-PROG-3SG-1PL
-ka-št-is-maan-aa	-VTR-PROG-3SG-1PL-REM
-ka-št-is-maan-ee	-VTR-PROG-3SG-1PL-PRES
-ka-št-is-r	-VTR-PROG-3SG-2SG
-ka-št-is-r-aa	-VTR-PROG-3SG-2SG-REM
-ka-št-is-r-ee	-VTR-PROG-3SG-2SG-PRES
-ka-št-is-raan	-VTR-PROG-3SG-2PL
-ka-št-is-raan-aa	-VTR-PROG-3SG-2PL-REM
-ka-št-is-raan-ee	-VTR-PROG-3SG-2PL-PRES
-ka-št-is-s	-VTR-PROG-3SG-3SG
-ka-št-is-s-aa	-VTR-PROG-3SG-3SG-REM
-ka-št-is-s-ee	-VTR-PROG-3SG-3SG-PRES
-ka-št-is-saan	-VTR-PROG-3SG-3PL
-ka-št-is-saan-aa	-VTR-PROG-3SG-3PL-REM
-ka-št-is-saan-ee	-VTR-PROG-3SG-3PL-PRES
-ka-št-iss	-VTR-PROG-2PL
-ka-št-iss-aa	-VTR-PROG-2PL-REM
-ka-št-iss-ee	-VTR-PROG-2PL-PRES
-ka-št-m-ir-aa	-VTR-PROG-1SG-2SG-REM
-ka-št-m-ir-ee	-VTR-PROG-1SG-2SG-PRES
-ka-št-m-iraan-aa	-VTR-PROG-1SG-2PL-REM
-ka-št-m-iraan-ee	-VTR-PROG-1SG-2PL-PRES
-ka-št-m-is-aa	-VTR-PROG-1SG-3SG-REM
-ka-št-m-is-ee	-VTR-PROG-1SG-3SG-PRES
-ka-št-m-isaan-aa	-VTR-PROG-1SG-3PL-REM
-ka-št-m-isaan-ee	-VTR-PROG-1SG-3PL-PRES
-ka-št-om	-VTR-PROG-1SG
-ka-št-om-aa	-VTR-PROG-1SG-REM
-ka-št-om-a	-VTR-PROG-1SG-REM
-ka-št-om-ee	-VTR-PROG-1SG-PRES
-ka-št-om-ir-aa	-VTR-PROG-1SG-2SG-REM
-ka-št-om-ir-ee	-VTR-PROG-1SG-2SG-PRES
-ka-št-om-iraan-aa	-VTR-PROG-1SG-2PL-REM
-ka-št-om-iraan-ee	-VTR-PROG-1SG-2PL-PRES
-ka-št-om-is-aa	-VTR-PROG-1SG-3SG-REM
-ka-št-om-is-ee	-VTR-PROG-1SG-3SG-PRES
-ka-št-om-isaan-aa	-VTR-PROG-1SG-3PL-REM
-ka-št-om-isaan-ee	-VTR-PROG-1SG-3PL-PRES
-ka-št-om-r-aa	-VTR-PROG-1SG-2SG-REM
-ka-št-om-r-ee	-VTR-PROG-1SG-2SG-PRES
-ka-št-om-raan-aa	-VTR-PROG-1SG-2PL-REM
-ka-št-om-raan-ee	-VTR-PROG-1SG-2PL-PRES
-ka-št-om-s-aa	-VTR-PROG-1SG-3SG-REM
-ka-št-om-s-ee	-VTR-PROG-1SG-3SG-PRES
-ka-št-om-saan-aa	-VTR-PROG-1SG-3PL-REM
-ka-št-om-saan-ee	-VTR-PROG-1SG-3PL-PRES
-ka-št-or	-VTR-PROG-2SG
-ka-št-or-aa	-VTR-PROG-2SG-REM
-ka-št-or-ee	-VTR-PROG-2SG-PRES
-ka-št-or-im	-VTR-PROG-2SG-1SG
-ka-št-or-im-aa	-VTR-PROG-2SG-1SG-REM
-ka-št-or-im-ee	-VTR-PROG-2SG-1SG-PRES
-ka-št-or-imaa	-VTR-PROG-2SG-1PL
-ka-št-or-imaan	-VTR-PROG-2SG-1PL
-ka-št-or-imaan-aa	-VTR-PROG-2SG-1PL-REM
-ka-št-or-imaan-ee	-VTR-PROG-2SG-1PL-PRES
-ka-št-or-is	-VTR-PROG-2SG-3SG
-ka-št-or-is-aa	-VTR-PROG-2SG-3SG-REM
-ka-št-or-is-ee	-VTR-PROG-2SG-3SG-PRES
-ka-št-or-isaa	-VTR-PROG-2SG-3PL
-ka-št-or-isaan	-VTR-PROG-2SG-3PL
-ka-št-or-isaan-aa	-VTR-PROG-2SG-3PL-REM
-ka-št-or-isaan-ee	-VTR-PROG-2SG-3PL-PRES
-ka-št-or-m-aa	-VTR-PROG-2SG-1SG-REM
-ka-št-or-m-ee	-VTR-PROG-2SG-1SG-PRES
-ka-št-or-maan-aa	-VTR-PROG-2SG-1PL-REM
-ka-št-or-maan-ee	-VTR-PROG-2SG-1PL-PRES
-ka-št-or-s-aa	-VTR-PROG-2SG-3SG-REM
-ka-št-or-s-ee	-VTR-PROG-2SG-3SG-PRES
-ka-št-or-saan-aa	-VTR-PROG-2SG-3PL-REM
-ka-št-or-saan-ee	-VTR-PROG-2SG-3PL-PRES
-ka-št-r-im-aa	-VTR-PROG-3SG-1SG-REM
-ka-št-r-im-ee	-VTR-PROG-3SG-1SG-PRES
-ka-št-r-imaan-aa	-VTR-PROG-3SG-1PL-REM
-ka-št-r-imaan-ee	-VTR-PROG-3SG-1PL-PRES
-ka-št-r-ir-aa	-VTR-PROG-3SG-2SG-REM
-ka-št-r-ir-ee	-VTR-PROG-3SG-2SG-PRES
-ka-št-r-iraan-aa	-VTR-PROG-3SG-2PL-REM
-ka-št-r-iraan-ee	-VTR-PROG-3SG-2PL-PRES
-ka-št-r-is-aa	-VTR-PROG-3SG-3SG-REM
-ka-št-r-is-ee	-VTR-PROG-3SG-3SG-PRES
-ka-št-r-isaan-aa	-VTR-PROG-3SG-3PL-REM
-ka-št-r-isaan-ee	-VTR-PROG-3SG-3PL-PRES
-kaa	-DIR
-in-kaa	-OBL.PL-DIR
-ees-kaa	-OBL.SG-DIR
-kar	-VTR
-kar-os	-VTR-3SG
-kar-osaan-ee	-VTR-3PL-PRES
-kar-aa	-VTR-2SG/CAUS
-kar-aa-d-à	-VTR-CAUS-PFV-3SG
-kar-aa-d-om	-VTR-CAUS-PFV-1SG
-kar-aa-d-om-is	-VTR-CAUS-PFV-1SG-3SG
-kar-aa-m-isaan-aa	-VTR-CAUS-1SG-3PL-REM
-aa-d-om-is	-CAUS-PFV-1SG-3SG
-aa-d-om-is-aa	-CAUS-PFV-1SG-3SG-REM
-aa-d-om-is-ee	-CAUS-PFV-1SG-3SG-PRES
-aa-d-os-s-ee	-CAUS-PFV-3SG-3SG-PRES
-aa-d-os-s-aa	-CAUS-PFV-3SG-3SG-REM
-aa-d-os-saan	-CAUS-PFV-3SG-3PL
-aa-d-os-saa	-CAUS-PFV-3SG-3PL
-aa-d-os-saan-ee	-CAUS-PFV-3SG-3PL-PRES
-aa-d-os-saan-aa	-CAUS-PFV-3SG-3PL-REM
-kar-d-à	-VTR-PFV-3SG
-kar-d-a	-VTR-PFV-REM
-kar-d-aa	-VTR-PFV-REM
-kar-d-ee	-VTR-PFV-PRES
-kar-d-een	-VTR-PFV-1PL
-kar-d-een-aa	-VTR-PFV-1PL-REM
-kar-d-een-ir	-VTR-PFV-1PL-2SG
-kar-d-een-ir-aa	-PFV-1PL-2SG-REM
-kar-d-een-ir-ee	-PFV-1PL-2SG-PRES
-kar-d-een-iraa	-VTR-PFV-1PL-2PL
-kar-d-een-iraan	-VTR-PFV-1PL-2PL
-kar-d-een-iraan-aa	-PFV-1PL-2PL-REM
-kar-d-een-iraan-ee	-PFV-1PL-2PL-PRES
-kar-d-een-is	-VTR-PFV-1PL-3SG
-kar-d-een-is-aa	-PFV-1PL-3SG-REM
-kar-d-een-is-ee	-PFV-1PL-3SG-PRES
-kar-d-een-isaa	-VTR-PFV-1PL-3PL
-kar-d-een-isaan	-VTR-PFV-1PL-3PL
-kar-d-een-isaan-aa	-PFV-1PL-3PL-REM
-kar-d-een-isaan-ee	-PFV-1PL-3PL-PRES
-kar-d-eend	-VTR-PFV-3PL
-kar-d-eend-ee	-VTR-PFV-3PL-PRES
-kar-d-eend-aa	-VTR-PFV-3PL-REM
-kar-d-eend-im	-VTR-PFV-3PL-1SG
-kar-d-eend-im-aa	-PFV-3PL-1SG-REM
-kar-d-eend-im-ee	-PFV-3PL-1SG-PRES
-kar-d-eend-imaa	-VTR-PFV-3PL-1PL
-kar-d-eend-imaan	-VTR-PFV-3PL-1PL
-kar-d-eend-imaan-aa	-PFV-3PL-1PL-REM
-kar-d-eend-imaan-ee	-PFV-3PL-1PL-PRES
-kar-d-eend-ir	-VTR-PFV-3PL-2SG
-kar-d-eend-ir-aa	-PFV-3PL-2SG-REM
-kar-d-eend-ir-ee	-PFV-3PL-2SG-PRES
-kar-d-eend-iraa	-VTR-PFV-3PL-2PL
-kar-d-eend-iraan	-VTR-PFV-3PL-2PL
-kar-d-eend-iraan-aa	-PFV-3PL-2PL-REM
-kar-d-eend-iraan-ee	-PFV-3PL-2PL-PRES
-kar-d-eend-is	-VTR-PFV-3PL-3SG
-kar-d-eend-is-aa	-PFV-3PL-3SG-REM
-kar-d-eend-is-ee	-PFV-3PL-3SG-PRES
-kar-d-eend-isaa	-VTR-PFV-3PL-3PL
-kar-d-eend-isaan	-VTR-PFV-3PL-3PL
-kar-d-eend-isaan-aa	-PFV-3PL-3PL-REM
-kar-d-eend-isaan-ee	-PFV-3PL-3PL-PRES
-kar-d-ees	-VTR-PFV-2PL
-kar-d-ees-ee	-VTR-PFV-2PL-PRES
-kar-d-ees-aa	-VTR-PFV-2PL-REM
-kar-d-ees-im	-VTR-PFV-2PL-1SG
-kar-d-ees-im-aa	-PFV-2PL-1SG-REM
-kar-d-ees-im-ee	-PFV-2PL-1SG-PRES
-kar-d-ees-imaa	-VTR-PFV-2PL-1PL
-kar-d-ees-imaan	-VTR-PFV-2PL-1PL
-kar-d-ees-imaan-aa	-PFV-2PL-1PL-REM
-kar-d-ees-imaan-ee	-PFV-2PL-1PL-PRES
-kar-d-ees-iraa	-VTR-PFV-2PL-2PL
-kar-d-ees-iraan	-VTR-PFV-2PL-1PL
-kar-d-ees-iraan-aa	-PFV-2PL-1PL-REM
-kar-d-ees-iraan-ee	-PFV-2PL-1PL-PRES
-kar-d-ees-is	-VTR-PFV-2PL-3SG
-kar-d-ees-is-aa	-PFV-2PL-3SG-REM
-kar-d-ees-is-ee	-PFV-2PL-3SG-PRES
-kar-d-om	-VTR-PFV-1SG
-kar-d-om-ee	-VTR-PFV-1SG-PRES
-kar-d-om-aa	-VTR-PFV-1SG-REM
-kar-d-om-ir	-VTR-PFV-1SG-2SG
-kar-d-om-ir-aa	-PFV-1SG-2SG-REM
-kar-d-om-ir-ee	-VTR-PFV-1SG-2SG-PRES
-kar-d-om-iraa	-VTR-PFV-1SG-2PL
-kar-d-om-iraan	-VTR-PFV-1SG-2PL
-kar-d-om-iraan-aa	-PFV-1SG-2PL-REM
-kar-d-om-iraan-ee	-VTR-PFV-1SG-2PL-PRES
-kar-d-om-is	-VTR-PFV-1SG-3SG
-kar-d-om-is-aa	-PFV-1SG-3SG-REM
-kar-d-om-is-ee	-VTR-PFV-1SG-3SG-PRES
-kar-d-om-isaa	-VTR-PFV-1SG-3PL
-kar-d-om-isaan	-VTR-PFV-1SG-3PL
-kar-d-om-isaan-aa	-PFV-1SG-3PL-REM
-kar-d-om-isaan-ee	-VTR-PFV-1SG-3PL-PRES
-kar-d-or	-VTR-PFV-2SG
-kar-d-or-aa	-VTR-PFV-2SG-REM
-kar-d-or-im	-VTR-PFV-2SG-1SG
-kar-d-or-im-aa	-PFV-2SG-1SG-REM
-kar-d-or-im-ee	-VTR-PFV-2SG-1SG-PRES
-kar-d-or-imaa	-VTR-PFV-2SG-1PL
-kar-d-or-imaan	-VTR-PFV-2SG-1PL
-kar-d-or-imaan-aa	-PFV-2SG-1PL-REM
-kar-d-or-imaan-ee	-PFV-2SG-1PL-PRES
-kar-d-or-is	-VTR-PFV-2SG-3SG
-kar-d-or-is-aa	-PFV-2SG-3SG-REM
-kar-d-or-is-ee	-VTR-PFV-2SG-3SG-PRES
-kar-d-or-isaa	-VTR-PFV-2SG-3PL
-kar-d-or-isaan	-VTR-PFV-2SG-3PL
-kar-d-or-isaan-aa	-PFV-2SG-3PL-REM
-kar-d-or-isaan-ee	-PFV-2SG-3PL-PRES
-kar-d-os	-VTR-PFV-3SG
-kar-d-os-im	-VTR-PFV-3SG-1SG
-kar-d-os-im-aa	-PFV-3SG-1SG-REM
-kar-d-os-im-ee	-VTR-PFV-3SG-1SG-PRES
-kar-d-os-imaa	-VTR-PFV-3SG-1PL
-kar-d-os-imaan	-VTR-PFV-3SG-1PL
-kar-d-os-imaan-aa	-PFV-3SG-1PL-REM
-kar-d-os-imaan-ee	-VTR-PFV-3SG-1PL-PRES
-kar-d-os-ir	-VTR-PFV-3SG-2SG
-kar-d-os-ir-aa	-PFV-3SG-2SG-REM
-kar-d-os-ir-ee	-VTR-PFV-3SG-2SG-PRES
-kar-d-os-iraa	-VTR-PFV-3SG-2PL
-kar-d-os-iraan	-VTR-PFV-3SG-2PL
-kar-d-os-iraan-aa	-PFV-3SG-2PL-REM
-kar-d-os-iraan-ee	-VTR-PFV-3SG-2PL-PRES
-kar-d-os-is	-VTR-PFV-3SG-3SG
-kar-d-os-is-aa	-PFV-3SG-3SG-REM
-kar-d-os-is-ee	-VTR-PFV-3SG-3SG-PRES
-kar-d-os-isaa	-VTR-PFV-3SG-3PL
-kar-d-os-isaan	-VTR-PFV-3SG-3PL
-kar-d-os-isaan-aa	-PFV-3SG-3PL-REM
-kar-d-os-isaan-ee	-VTR-PFV-3SG-3PL-PRES
-kar-d-os-s	-VTR-PFV-3SG-3SG
-kar-d-os-s-ee	-VTR-PFV-3SG-3SG-PRES
-kar-d-os-san	-VTR-PFV-3SG-3PL
-kar-d-os-san-aa	-VTR-PFV-3SG-3PL-REM
-kar-d-os-san-ee	-VTR-PFV-3SG-3PL-PRES
-kar-d-os-saa	-VTR-PFV-3SG-3PL
-kar-d-os-saan	-VTR-PFV-3SG-3PL
-kar-im	-VTR-1SG
-kar-im-aa	-VTR-1SG-REM
-kar-in	-VTR-1PL
-kar-in-aa	-VTR-1PL-REM
-kar-n-aa	-VTR-1PL-REM
-kar-n-ee	-VTR-1PL-PRES
-kar-n-isaa	-VTR-1PL-3PL
-kar-n-isaan-ee	-VTR-1PL-3PL-PRES
-n-isaan-ee	-1PL-3PL-PRES
-n-saa	-1PL-3PL
-kar-n-is-ee	-VTR-1PL-3SG-PRES
-kar-ind	-VTR-3PL
-kar-ind-aa	-VTR-3PL-REM
-kar-ind-ee	-VTR-3PL-PRES
-kar-ind-im-ee	-VTR-3PL-1SG-PRES
-kar-ind-imaan	-VTR-3PL-1PL
-kar-ind-imaan-ee	-VTR-3PL-1PL-PRES
-kar-ind-imaan-aa	-VTR-3PL-1PL-REM
-kar-ind-isaan	-VTR-3PL-3PL
-kar-ind-is-aa	-VTR-3PL-3SG-REM
-kar-ind-is-ee	-VTR-3PL-3SG-PRES
-kar-ind-s-ee	-VTR-3PL-3SG-PRES
-kar-ir	-VTR-3SG
-kar-ir-aa	-VTR-3SG-REM
-kar-m-ee	-VTR-1SG-PRES
-kar-m-aa	-VTR-1SG-REM
-kar-m-ir	-VTR-1SG-2SG
-kar-m-ir-ee	-VTR-1SG-2SG-PRES
-kar-m-iraan	-VTR-1SG-2PL
-kar-m-is	-VTR-1SG-3SG
-kar-m-is-ee	-VTR-1SG-3SG-PRES
-kar-m-isaan	-VTR-1SG-3PL
-kar-m-isaan-ee	-VTR-1SG-3PL-PRES
-kar-om-ee	-VTR-1SG-PRES
-kar-r-ee	-VTR-3SG-PRES
-kar-r-aa	-VTR-3SG-REM
-kar-s-aa	-VTR-2PL-REM
-kar-is	-VTR-2PL
-kar-s-im	-VTR-3SG-1SG
-kar-s-ir	-VTR-3SG-2SG
-kar-s-is	-VTR-3SG-3SG
-kar-s-imaan	-VTR-3SG-1PL
-kar-s-iraan	-VTR-3SG-2PL
-kar-s-isaan	-VTR-3SG-3PL
-kar-s-imaa	-VTR-3SG-1PL
-kar-s-iraa	-VTR-3SG-2PL
-kar-s-isaa	-VTR-3SG-3PL
-kar-r-im-ee	-VTR-3SG-1SG-PRES
-kar-r-is-ee	-VTR-3SG-3SG-PRES
-kar-r-is-aa	-VTR-3SG-3SG-REM
-kar-r-imaa	-VTR-3SG-1PL
-kar-r-imaan	-VTR-3SG-1PL
-kar-r-imaan-ee	-VTR-3SG-1PL-PRES
-kar-r-imaan-aa	-VTR-3SG-1PL-REM
-kr-om-ee	-VTR-1SG-PRES
-kr-om-aa	-VTR-1SG-REM
-kr-om	-VTR-1SG
-kr-or-ee	-VTR-2SG-PRES
-kr-or-aa	-VTR-2SG-REM
-kr-or	-VTR-2SG
-kr-os-im	-VTR-3SG-1SG
-kr-os-im-ee	-VTR-3SG-1SG-PRES
-kr-os-im-aa	-VTR-3SG-1SG-REM
-kr-os-imaa	-VTR-3SG-1PL
-kr-os-is	-VTR-3SG-3SG
-kr-os-saa	-VTR-3SG-3PL
-kr-os-saan-ee	-VTR-3SG-3PL-PRES
-k-r-eend	-VTR-PFV-3PL
-k-r-eend-ee	-VTR-PFV-3PL-PRES
-k-r-eend-aa	-VTR-PFV-3PL-REM
-k-r-eend-is	-VTR-PFV-3PL-3SG
-k-r-eend-im	-VTR-PFV-3PL-1SG
-k-r-eend-imaa	-VTR-PFV-3PL-1PL
-k-r-een-is	 -VTR-PFV-1PL-3SG
-k-r-een-im	 -VTR-PFV-1PL-1SG
-k-r-een-ir	 -VTR-PFV-1PL-2SG
-k-r-een-isaan	 -VTR-PFV-1PL-3PL
-k-r-een-isaa	 -VTR-PFV-1PL-3PL
-k-r-een-iraan	 -VTR-PFV-1PL-2PL
-k-r-een-iraa	 -VTR-PFV-1PL-2PL
-k-r-een-imaan	 -VTR-PFV-1PL-1PL
-k-r-een-imaa	 -VTR-PFV-1PL-1PL
-k-r-een-ee	-VTR-PFV-1PL-PRES
-k-r-een-aa	-VTR-PFV-1PL-REM
-k-r-os-s	-VTR-PFV-3SG-3SG
-k-r-om-is	-VTR-PFV-1SG-3SG
-k-r-om-is-ee	-VTR-PFV-1SG-3SG-PRES
-k-r-om-is-aa	-VTR-PFV-1SG-3SG-REM
-k-r-os-s-ee	-VTR-PFV-3SG-3SG-PRES
-k-r-os-s-aa	-VTR-PFV-3SG-3SG-REM
-k-r-os-s	-VTR-PFV-3SG-3SG
-k-r-à	-VTR-PFV-3SG
-r-om-isaa	-PFV-1SG-3PL
-r-om-is	-PFV-1SG-3SG
-om-is	-1SG-3SG
-s-imaa	-3SG-1PL
-kee	-BEN
-keer	-BEN
-keer-om	-BEN-1SG
-keer-omaa	-BEN-1PL
-keer-omaan	-BEN-1PL
-keer-or	-BEN-2SG
-keer-oraa	-BEN-2PL
-keer-oraan	-BEN-2PL
-keer-os	-BEN-3SG
-keer-osaa	-BEN-3PL
-keer-osaan	-BEN-3PL
-keera	-BEN
-keerà	-BEN
-keeree	-BEN
-kii	-ABL
-k	-ABL
-l-à	-PFV-3SG
-l-ee	-3SG-PRES
-l-een	-PFV-1PL
-l-m-aa	-PFV-1SG-REM
-m	-LOC/1SG
-m-aa	-1SG-REM
-m-ee	-1SG-PRES
-m-ir	-1SG-2SG
-m-ir-aa	-1SG-2SG-REM
-m-ir-ee	-1SG-2SG-PRES
-m-iraan	-1SG-2PL
-m-iraan-aa	-1SG-2PL-REM
-m-iraan-ee	-1SG-2PL-PRES
-aa-m-iraan-ee	-CAUS-1SG-2PL-PRES
-m-is	-1SG-3SG
-m-is-aa	-1SG-3SG-REM
-m-is-ee	-1SG-3SG-PRES
-m-isaan	-1SG-3PL
-m-isaa	-1SG-3PL
-m-isaan-aa	-1SG-3PL-REM
-m-isaan-ee	-1SG-3PL-PRES
-ma	-LOC
-mà	-LOC
-imaa	-LOC.REM
mà	NEG
-mà-	-NEG-
-mee	-LOC
-imee	-LOC
-ee-mà	-PL-LOC
-mor	-DER/-INDEF
-n	-1PL
-n-	-NEG-
-n-ee	-1PL-PRES
-nà	-NEG
nà-	NEG-
-nà-	-NEG-
-naa	-CAUS
-naa-d-à	-CAUS-PFV-3SG
-naa-d-aa	-CAUS-PFV-REM
-naa-d-ee	-CAUS-PFV-PRES
-naa-d-een	-CAUS-PFV-1PL
-naa-d-een-aa	-CAUS-PFV-1PL-REM
-naa-d-een-ee	-CAUS-PFV-1PL-PRES
-naa-d-eend	-CAUS-PFV-3PL
-naa-d-eend-aa	-CAUS-PFV-3PL-REM
-naa-d-eend-ee	-CAUS-PFV-3PL-PRES
-naa-d-eend-is-ee	-CAUS-PFV-3PL-3SG-PRES
-naa-d-eend-is-aa	-CAUS-PFV-3PL-3SG-REM
-naa-d-eend-im	-CAUS-PFV-3PL-1SG
-naa-d-eend-im-ee	-CAUS-PFV-3PL-1SG-PRES
-naa-d-eend-im-aa	-CAUS-PFV-3PL-1SG-REM
-naa-d-eend-ir-ee	-CAUS-PFV-3PL-2SG-PRES
-naa-d-eend-ir-aa	-CAUS-PFV-3PL-2SG-REM
-naa-d-ees	-CAUS-PFV-2PL
-naa-d-ees-aa	-CAUS-PFV-2PL-REM
-naa-d-ees-ee	-CAUS-PFV-2PL-PRES
-naa-d-om	-CAUS-PFV-1SG
-naa-d-om-aa	-CAUS-PFV-1SG-REM
-naa-d-om-ee	-CAUS-PFV-1SG-PRES
-naa-d-or	-CAUS-PFV-2SG
-naa-d-or-ee	-CAUS-PFV-2SG-PRES
-naa-d-os	-CAUS-PFV-3SG
-naa-d-os-im	-CAUS-PFV-3SG-1SG
-naa-d-os-ir	-CAUS-PFV-3SG-2SG
-naa-d-os-is	-CAUS-PFV-3SG-3SG
-naa-d-os-imaa	-CAUS-PFV-3SG-1PL
-naa-d-os-iraa	-CAUS-PFV-3SG-2PL
-naa-d-os-isaa	-CAUS-PFV-3SG-3PL
-naa-d-os-imaan	-CAUS-PFV-3SG-1PL
-naa-d-os-iraan	-CAUS-PFV-3SG-2PL
-naa-d-os-isaan	-CAUS-PFV-3SG-3PL
-naa-in-aa	-CAUS-1PL-REM
-naa-in-ee	-CAUS-1PL-PRES
-naa-n-aa	-CAUS-1PL-REM
-naa-n-ee	-CAUS-1PL-PRES
-naa-ind-aa	-CAUS-3PL-REM
-naa-ind-ee	-CAUS-3PL-PRES
-naa-is-aa	-CAUS-2PL-REM
-naa-is-ee	-CAUS-2PL-PRES
-naa-m	-CAUS-1SG
-naa-m-aa	-CAUS-1SG-REM
-naa-m-ee	-CAUS-1SG-PRES
-naa-m-is-ee	-CAUS-1SG-3SG-PRES
-naa-m-is-aa	-CAUS-1SG-3SG-REM
-naa-m-isaan-aa	-CAUS-1SG-3PL-REM
-naa-m-isaan-ee	-CAUS-1SG-3PL-PRES
-naa-m-isaan	-CAUS-1SG-3PL
-naa-nd-aa	-CAUS-3PL-REM
-naa-nd-ee	-CAUS-3PL-PRES
-naa-nd-is-ee	-CAUS-3PL-3SG-PRES
-naa-nd-is-aa	-CAUS-3PL-3SG-REM
-naa-nd-is	-CAUS-3PL-3SG
-naa-r	-CAUS-3SG
-naa-r-aa	-CAUS-3SG-REM
-naa-r-ee	-CAUS-3SG-PRES
-naa-r-à	-CAUS-PFV-3SG
-naa-r-is-ee	-CAUS-PFV-3SG-PRES
-naa-r-is-aa	-CAUS-PFV-3SG-REM
-naa-r-is	-CAUS-PFV-3SG
-naa-rd-à	-CAUS-PFV-3SG
-naa-rd-aa	-CAUS-PFV-REM
-naa-rd-ee	-CAUS-PFV-PRES
-naa-rd-een	-CAUS-PFV-1PL
-naa-rd-een-aa	-CAUS-PFV-1PL-REM
-naa-rd-een-ee	-CAUS-PFV-1PL-PRES
-naa-rd-eend	-CAUS-PFV-3PL
-naa-rd-eend-aa	-CAUS-PFV-3PL-REM
-naa-rd-eend-ee	-CAUS-PFV-3PL-PRES
-rd-eend-ee	-PFV-3PL-PRES
-naa-rd-ees	-CAUS-PFV-2PL
-naa-rd-ees-aa	-CAUS-PFV-2PL-REM
-naa-rd-ees-ee	-CAUS-PFV-2PL-PRES
-naa-rd-om	-CAUS-PFV-1SG
-naa-rd-om-aa	-CAUS-PFV-1SG-REM
-naa-rd-om-ee	-CAUS-PFV-1SG-PRES
-naa-rd-or	-CAUS-PFV-2SG
-naa-rd-or-ee	-CAUS-PFV-2SG-PRES
-naa-rd-os	-CAUS-PFV-3SG
-naaav	-CAUS
-naar	-CAUS
-naav-išt-aa	-CAUS-PROG-REM
-naav-išt-ee	-CAUS-PROG-PRES
-naav-išt-ind	-CAUS-PROG-3PL
-naav-išt-ind-aa	-CAUS-PROG-3PL-REM
-naav-išt-ind-ee	-CAUS-PROG-3PL-PRES
-naav-išt-inn	-CAUS-PROG-1PL
-naav-išt-inn-aa	-CAUS-PROG-1PL-REM
-naav-išt-inn-ee	-CAUS-PROG-1PL-PRES
-naav-išt-ir-s-ee	-CAUS-PROG-3SG-3SG-PRES
-naav-išt-iss	-CAUS-PROG-2PL
-naav-išt-iss-aa	-CAUS-PROG-2PL-REM
-naav-išt-iss-ee	-CAUS-PROG-2PL-PRES
-naav-išt-om	-CAUS-PROG-1SG
-naav-išt-om-aa	-CAUS-PROG-1SG-REM
-naav-išt-om-ee	-CAUS-PROG-1SG-PRES
-naav-išt-or	-CAUS-PROG-2SG
-naav-išt-or-aa	-CAUS-PROG-2SG-REM
-naav-išt-or-ee	-CAUS-PROG-2SG-PRES
-nd	-3PL
-nd-aa	-3PL-REM
-o	-VITR
-o-čč-aa	-VITR-SUBJ-2SG
-o-čč-im	-VITR-SUBJ-1SG
-o-čč-im-ir	-VITR-SUBJ-1SG-2SG
-o-čč-in	-VITR-SUBJ-1PL
-o-čč-ind	-VITR-SUBJ-3PL
-o-čč-ir	-VITR-SUBJ-3SG
-o-čč-ir-aa	-VITR-SUBJ-3SG-REM
-o-čč-ir-ee	-VITR-SUBJ-3SG-PRES
-o-čč-er	-VITR-SUBJ-3SG
-o-čč-is	-VITR-SUBJ-2PL
-o-č-aa	-VITR-SUBJ-2SG
-o-č-im	-VITR-SUBJ-1SG
-o-č-im-ir	-VITR-SUBJ-1SG-2SG
-o-č-in	-VITR-SUBJ-1PL
-o-č-ind	-VITR-SUBJ-3PL
-o-č-ir	-VITR-SUBJ-3SG
-o-č-er	-VITR-SUBJ-3SG
-o-č-is	-VITR-SUBJ-2PL
-o-ty-ee	-VITR-SUBJ-PRES
-o-ty-aa	-VITR-SUBJ-2SG
-o-ty-im	-VITR-SUBJ-1SG
-o-ty-im-ir	-VITR-SUBJ-1SG-2SG
-o-ty-in	-VITR-SUBJ-1PL
-o-ty-ind	-VITR-SUBJ-3PL
-o-ty-ir	-VITR-SUBJ-3SG
-o-ty-er	-VITR-SUBJ-3SG
-o-ty-is	-VITR-SUBJ-2PL
-o-ty-im-ee	-VITR-SUBJ-1SG-PRES
-o-ty-im-ir-ee	-VITR-SUBJ-1SG-2SG-PRES
-o-ty-in-ee	-VITR-SUBJ-1PL-PRES
-o-ty-ind-ee	-VITR-SUBJ-3PL-PRES
-o-ty-ir-ee	-VITR-SUBJ-3SG-PRES
-o-ty-er-ee	-VITR-SUBJ-3SG-PRES
-o-ty-is-ee	-VITR-SUBJ-2PL-PRES
-o-ty-im-aa	-VITR-SUBJ-1SG-REM
-o-ty-im-ir-aa	-VITR-SUBJ-1SG-2SG-REM
-o-ty-in-aa	-VITR-SUBJ-1PL-REM
-o-ty-ind-aa	-VITR-SUBJ-3PL-REM
-o-ty-ir-aa	-VITR-SUBJ-3SG-REM
-o-ty-er-aa	-VITR-SUBJ-3SG-REM
-o-ty-is-aa	-VITR-SUBJ-2PL-REM
-ty-ind-ir-aa	-SUBJ-3PL-2SG-REM
-ty-ind-ir-ee	-SUBJ-3PL-2SG-PRES
-o-m	-SG-1SG
-o-m-aa	-VITR-1SG-REM
-o-m-ee	-VITR-1SG-PRES
-o-maa	-SG-1PL
-o-maan	-SG-1PL
-o-maan-ee	-SG-1PL-PRES
-o-maan-aa	-SG-1PL-REM
-o-n-aa	-VITR-1PL-REM
-o-n-ee	-VITR-1PL-PRES
-o-nd-aa	-VITR-3PL-REM
-o-nd-ee	-VITR-3PL-PRES
-nd-ee	-3PL-PRES
-o-r	-SG-2SG/-VITR-3SG
-o-r-aa	-VITR-3SG-REM
-o-r-ee	-VITR-3SG-PRES
-o-rr-ee	-VITR-3SG-PRES
-o-raa	-SG-2PL
-o-raan	-SG-2PL
-o-s	-SG-3SG
-o-s-aa	-VITR-2PL-REM
-s-aa	-2PL-REM
-o-s-ee	-VITR-2PL-PRES
-o-saa	-SG-3PL
-o-saan	-SG-3PL
-o-tii	-VITR-2SG.IMP
-w-osaa	-2SG-3PL
-o-w-aa	-VITR-2SG-REM
-o-w-ee	-VITR-2SG-PRES
-o-w-osaan-ee	-VITR-2SG-3PL-PRES
-w-osaan-ee	-2SG-3PL-PRES
-om	-1SG
-om-aa	-1SG-REM
-om-ir-aa	-1SG-2SG-REM
-om-ir-ee	-1SG-2SG-PRES
-om-iraan-aa	-1SG-2PL-REM
-om-iraan-ee	-1SG-2PL-PRES
-om-is-aa	-1SG-3SG-REM
-om-is-ee	-1SG-3SG-PRES
-om-isaan-aa	-1SG-3PL-REM
-om-isaan-ee	-1SG-3PL-PRES
-omaa	-1PL
-omaan	-1PL
-or	-2SG
-or-im	-2SG-1SG
-or-im-aa	-2SG-1SG-REM
-or-im-ee	-2SG-1SG-PRES
-or-imaa	-2SG-1PL
-or-imaan	-2SG-1PL
-or-imaan-aa	-2SG-1PL-REM
-or-imaan-ee	-2SG-1PL-PRES
-or-is	-2SG-3SG
-or-is-aa	-2SG-3SG-REM
-or-is-ee	-2SG-3SG-PRES
-or-isaa	-2SG-3PL
-or-isaan	-2SG-3PL
-or-isaan-aa	-2SG-3PL-REM
-or-isaan-ee	-2SG-3PL-PRES
-oraa	-2PL
-oraan	-2PL
-os	-3SG
-os-im	-3SG-1SG
-os-imaa	-3SG-1PL
-os-imaan	-3SG-1PL
-os-ir	-3SG-2SG
-os-iraa	-3SG-2PL
-os-iraan	-3SG-2PL
-os-is	-3SG-3SG
-os-isaa	-3SG-3PL
-os-isaan	-3SG-3PL
-r	-3SG
-r-à	-PFV-3SG
-r-aa	-PFV-REM
-l-aa	-PFV-REM
-r-ee	-3SG-PRES/-PFV-PRES
-r-een	-PFV-1PL
-r-een-aa	-PFV-1PL-REM
-r-een-ee	-PFV-1PL-PRES
-r-eend	-PFV-3PL
-l-eend	-PFV-3PL
-r-eend-aa	-PFV-3PL-REM
-r-eend-ee	-PFV-3PL-PRES
-r-eend-is	-PFV-3PL-3SG
-r-eend-is-ee	-PFV-3PL-3SG-PRES
-r-eend-ir-ee	-PFV-3PL-2SG-PRES
-r-eend-im-ee	-PFV-3PL-1SG-PRES
-r-eend-imaa	-PFV-3PL-1PL
-r-ees	-PFV-2PL
-r-ees-aa	-PFV-2PL-REM
-r-im-aa	-3SG-1SG-REM
-r-im-ee	-3SG-1SG-PRES
-r-imaa	-3SG-1PL
-r-imaan-aa	-3SG-1PL-REM
-r-imaan-ee	-3SG-1PL-PRES
-r-ir-aa	-3SG-2SG-REM
-r-ir-ee	-3SG-2SG-PRES
-r-iraan-aa	-3SG-2PL-REM
-r-iraan-ee	-3SG-2PL-PRES
-r-is	-3SG-3SG
-r-is-aa	-3SG-3SG-REM
-r-is-ee	-3SG-3SG-PRES
-r-s-ee	-3SG-3SG-PRES
-r-isaan-aa	-3SG-3PL-REM
-r-isaan-ee	-3SG-3PL-PRES
-r-om	-PFV-1SG
-r-om-aa	-PFV-1SG-REM
-r-om-ee	-PFV-1SG-PRES
-r-oom-ee	-PFV-1SG-PRES
-r-or	-PFV-2SG
-r-or-aa	-PFV-2SG-REM
-r-or-ee	-PFV-2SG-PRES
-r-or-is	-PFV-2SG-3SG
-r-os	-PFV-3SG
-r-os-ee	-PFV-3SG-PRES
-r-os-im	-PFV-3SG-1SG
-r-os-ir	-PFV-3SG-2SG
-r-os-is	-PFV-3SG-3SG
-r-os-saa	-PFV-3SG-3PL
-r-os-saan-ee	-PFV-3SG-3PL-PRES
-r-os-saan-aa	-PFV-3SG-3PL-REM
-r-os-imaa	-PFV-3SG-1PL
-r-os-iraa	-PFV-3SG-2PL
-r-os-isaa	-PFV-3SG-3PL
-r-os-imaan	-PFV-3SG-1PL
-r-os-iraan	-PFV-3SG-2PL
-r-os-isaan	-PFV-3SG-3PL
-r-os-im-ee	-PFV-3SG-1SG-PRES
-r-os-ir-ee	-PFV-3SG-2SG-PRES
-r-os-is-ee	-PFV-3SG-3SG-PRES
-r-os-imaan-ee	-PFV-3SG-1PL-PRES
-r-os-iraan-ee	-PFV-3SG-2PL-PRES
-r-os-isaan-ee	-PFV-3SG-3PL-PRES
-r-os-im-aa	-PFV-3SG-1SG-REM
-r-os-ir-aa	-PFV-3SG-2SG-REM
-r-os-is-aa	-PFV-3SG-3SG-REM
-r-os-imaan-aa	-PFV-3SG-1PL-REM
-r-os-iraan-aa	-PFV-3SG-2PL-REM
-r-os-isaan-aa	-PFV-3SG-3PL-REM
-raa	-VOC
-rd-à	-PFV-3SG
-rd-aa	-PFV-REM
-rd-een	-PFV-1PL
-rd-een-ee	-PFV-1PL-PRES
-rd-een-aa	-PFV-1PL-REM
-rd-een-ir	-PFV-1PL-2SG
-rd-een-ir-aa	-PFV-1PL-2SG-REM
-rd-een-ir-ee	-PFV-1PL-2SG-PRES
-rd-een-iraa	-PFV-1PL-2PL
-rd-een-iraan	-PFV-1PL-2PL
-rd-een-iraan-aa	-PFV-1PL-2PL-REM
-rd-een-iraan-ee	-PFV-1PL-2PL-PRES
-rd-een-is	-PFV-1PL-3SG
-rd-een-is-aa	-PFV-1PL-3SG-REM
-rd-een-is-ee	-PFV-1PL-3SG-PRES
-rd-een-isaa	-PFV-1PL-3PL
-rd-een-isaan	-PFV-1PL-3PL
-rd-een-isaan-aa	-PFV-1PL-3PL-REM
-rd-een-isaan-ee	-PFV-1PL-3PL-PRES
-rd-eend	-PFV-3PL
-rd-eend-aa	-PFV-3PL-REM
-rd-eend-im	-PFV-3PL-1SG
-rd-eend-im-aa	-PFV-3PL-1SG-REM
-rd-eend-im-ee	-PFV-3PL-1SG-PRES
-rd-eend-imaa	-PFV-3PL-1PL
-rd-eend-imaan	-PFV-3PL-1PL
-rd-eend-imaan-aa	-PFV-3PL-1PL-REM
-rd-eend-imaan-ee	-PFV-3PL-1PL-PRES
-rd-eend-ir	-PFV-3PL-2SG
-rd-eend-ir-aa	-PFV-3PL-2SG-REM
-rd-eend-ir-ee	-PFV-3PL-2SG-PRES
-rd-eend-iraa	-PFV-3PL-2PL
-rd-eend-iraan	-PFV-3PL-2PL
-rd-eend-iraan-aa	-PFV-3PL-2PL-REM
-rd-eend-iraan-ee	-PFV-3PL-2PL-PRES
-rd-eend-is	-PFV-3PL-3SG
-rd-eend-is-aa	-PFV-3PL-3SG-REM
-rd-eend-is-ee	-PFV-3PL-3SG-PRES
-rd-eend-isaa	-PFV-3PL-3PL
-rd-eend-isaan	-PFV-3PL-3PL
-rd-eend-isaan-aa	-PFV-3PL-3PL-REM
-rd-eend-isaan-ee	-PFV-3PL-3PL-PRES
-rd-ees	-PFV-2PL
-rd-ee	-PFV-PRES
-rd-ees-aa	-PFV-2PL-REM
-rd-ees-im	-PFV-2PL-1SG
-rd-ees-im-aa	-PFV-2PL-1SG-REM
-rd-ees-im-ee	-PFV-2PL-1SG-PRES
-rd-ees-imaa	-PFV-2PL-1PL
-rd-ees-imaan	-PFV-2PL-1PL
-rd-ees-imaan-aa	-PFV-2PL-1PL-REM
-rd-ees-imaan-ee	-PFV-2PL-1PL-PRES
-rd-ees-iraa	-PFV-2PL-2PL
-rd-ees-iraan	-PFV-2PL-1PL
-rd-ees-iraan-aa	-PFV-2PL-1PL-REM
-rd-ees-iraan-ee	-PFV-2PL-1PL-PRES
-rd-ees-is	-PFV-2PL-3SG
-rd-ees-is-aa	-PFV-2PL-3SG-REM
-rd-ees-is-ee	-PFV-2PL-3SG-PRES
-is-isaan-aa	-2PL-3PL-REM
-is-isaa-aa	-2PL-3PL-REM
-is-isaan-ee	-2PL-3PL-PRES
-is-isaa-ee	-2PL-3PL-PRES
-is-isaan	-2PL-3PL
-is-isaa	-2PL-3PL
-rd-om	-PFV-1SG
-rd-om-aa	-PFV-1SG-REM
-rd-om-ee	-PFV-1SG-PRES
-rd-om-ir	-PFV-1SG-2SG
-rd-om-ir-aa	-PFV-1SG-2SG-REM
-rd-om-ir-ee	-PFV-1SG-2SG-PRES
-rd-om-iraa	-PFV-1SG-2PL
-rd-om-iraan	-PFV-1SG-2PL
-rd-om-iraan-aa	-PFV-1SG-2PL-REM
-rd-om-iraan-ee	-PFV-1SG-2PL-PRES
-rd-om-is	-PFV-1SG-3SG
-rd-om-is-aa	-PFV-1SG-3SG-REM
-rd-om-is-ee	-PFV-1SG-3SG-PRES
-rd-om-isaa	-PFV-1SG-3PL
-rd-om-isaan	-PFV-1SG-3PL
-rd-om-isaan-aa	-PFV-1SG-3PL-REM
-rd-om-isaan-ee	-PFV-1SG-3PL-PRES
-rd-or	-PFV-2SG
-rd-or-im	-PFV-2SG-1SG
-rd-or-im-aa	-PFV-2SG-1SG-REM
-rd-or-im-ee	-PFV-2SG-1SG-PRES
-rd-or-imaa	-PFV-2SG-1PL
-rd-or-imaan	-PFV-2SG-1PL
-rd-or-imaan-aa	-PFV-2SG-1PL-REM
-rd-or-imaan-ee	-PFV-2SG-1PL-PRES
-rd-or-is	-PFV-2SG-3SG
-rd-or-is-aa	-PFV-2SG-3SG-REM
-rd-or-is-ee	-PFV-2SG-3SG-PRES
-rd-or-isaa	-PFV-2SG-3PL
-rd-or-isaan	-PFV-2SG-3PL
-rd-or-isaan-aa	-PFV-2SG-3PL-REM
-rd-or-isaan-ee	-PFV-2SG-3PL-PRES
-rd-os	-PFV-3SG
-rd-is-aa	-PFV-3SG-REM
-rd-os-im	-PFV-3SG-1SG
-rd-os-im-aa	-PFV-3SG-1SG-REM
-rd-os-im-ee	-PFV-3SG-1SG-PRES
-rd-os-imaa	-PFV-3SG-1PL
-rd-os-imaan	-PFV-3SG-1PL
-rd-os-imaan-aa	-PFV-3SG-1PL-REM
-rd-os-imaan-ee	-PFV-3SG-1PL-PRES
-rd-os-ir	-PFV-3SG-2SG
-rd-os-ir-aa	-PFV-3SG-2SG-REM
-rd-os-ir-ee	-PFV-3SG-2SG-PRES
-rd-os-iraa	-PFV-3SG-2PL
-rd-os-iraan	-PFV-3SG-2PL
-rd-os-iraan-aa	-PFV-3SG-2PL-REM
-rd-os-iraan-ee	-PFV-3SG-2PL-PRES
-rd-os-is	-PFV-3SG-3SG
-rd-os-is-aa	-PFV-3SG-3SG-REM
-rd-os-is-ee	-PFV-3SG-3SG-PRES
-rd-os-isaa	-PFV-3SG-3PL
-rd-os-isaan	-PFV-3SG-3PL
-rd-os-isaan-aa	-PFV-3SG-3PL-REM
-rd-os-isaan-ee	-PFV-3SG-3PL-PRES
-rd-os-s	-PFV-3SG-3SG
-rd-os-s-aa	-PFV-3SG-3SG-REM
-rd-os-s-ee	-PFV-3SG-3SG-PRES
-os-s-ee	-3SG-3SG-PRES
-s	-3SG/2PL/OBL.SG/2PL.IMP
-š-aa	-SUBJ/PROG-2SG
-š-aa-ee	-SUBJ/PROG-2SG-PRES
-š-ee	-SUBJ/PROG-PRES
-š-im	-SUBJ/PROG-1SG
-š-im-ee	-SUBJ/PROG-1SG-PRES
-š-im-aa	-SUBJ/PROG-1SG-REM
-š-in	-SUBJ/PROG-1PL
-š-n-ee	-SUBJ/PROG-1PL-PRES
-š-n-aa	-SUBJ/PROG-1PL-REM
-š-in-ee	-SUBJ/PROG-1PL-PRES
-š-in-aa	-SUBJ/PROG-1PL-REM
-š-ind	-SUBJ/PROG-3PL
-š-ind-ee	-SUBJ/PROG-3PL-PRES
-š-ind-aa	-SUBJ/PROG-3PL-REM
-š-ir	-SUBJ/PROG-3SG
-š-ir-ee	-SUBJ/PROG-3SG-PRES
-š-ir-aa	-SUBJ/PROG-3SG-REM
-š-is	-SUBJ/PROG-2PL
-š-is-ee	-SUBJ/PROG-2PL-PRES
-š-is-aa	-SUBJ/PROG-2PL-REM
-sa	-COND/SOC
-saa	-SOC/COND/3PL
-saan	-3PL
-see	-2PL.PRES
-šii	-too
-sii	-too
-ši	-too
-šš-aa	-SUBJ-2SG
-šš-aa-ee	-SUBJ-2SG-PRES
-šš-im	-SUBJ-1SG
-šš-im-ee	-SUBJ-1SG-PRES
-šš-in	-SUBJ-1PL
-šš-in-ee	-SUBJ-1PL-PRES
-šš-ind	-SUBJ-3PL
-šš-ind-ee	-SUBJ-3PL-PRES
-šš-ir	-SUBJ-3SG
-šš-ir-ee	-SUBJ-3SG-PRES
-šš-is	-SUBJ-2PL
-šš-is-ee	-SUBJ-2PL-PRES
-ssa	-SOC/COND
-št	-COP/PROG
-št-aa	-COP/PROG-REM
-št-ee	-COP/PROG-PRES
-št-im-ir-aa	-PROG-1SG-2SG-REM
-št-im-ir-ee	-PROG-1SG-2SG-PRES
-št-im-iraan-aa	-PROG-1SG-2PL-REM
-št-im-iraan-ee	-PROG-1SG-2PL-PRES
-št-im-is-aa	-PROG-1SG-3SG-REM
-št-im-is-ee	-PROG-1SG-3SG-PRES
-št-im-isaan-aa	-PROG-1SG-3PL-REM
-št-im-isaan-ee	-PROG-1SG-3PL-PRES
-št-im-r-aa	-PROG-1SG-2SG-REM
-št-im-r-ee	-PROG-1SG-2SG-PRES
-št-im-raan-aa	-PROG-1SG-2PL-REM
-št-im-raan-ee	-PROG-1SG-2PL-PRES
-št-im-s-aa	-PROG-1SG-3SG-REM
-št-im-s-ee	-PROG-1SG-3SG-PRES
-št-im-saan-aa	-PROG-1SG-3PL-REM
-št-im-saan-ee	-PROG-1SG-3PL-PRES
-št-ind	-COP/PROG-3PL
-št-ind-aa	-COP/PROG-3PL-REM
-št-ind-ee	-COP/PROG-3PL-PRES
-št-ind-im-aa	-PROG-3PL-1SG-REM
-št-ind-im-ee	-PROG-3PL-1SG-PRES
-št-ind-imaan-aa	-PROG-3PL-1PL-REM
-št-ind-imaan-ee	-PROG-3PL-1PL-PRES
-št-ind-ir-aa	-PROG-3PL-2SG-REM
-št-ind-ir-ee	-PROG-3PL-2SG-PRES
-št-ind-iraan-aa	-PROG-3PL-2PL-REM
-št-ind-iraan-ee	-PROG-3PL-2PL-PRES
-št-ind-is-aa	-PROG-3PL-3SG-REM
-št-ind-is-ee	-PROG-3PL-3SG-PRES
-št-ind-isaan-aa	-PROG-3PL-3PL-REM
-št-ind-isaan-ee	-PROG-3PL-3PL-PRES
-št-inn	-COP/PROG-1PL
-št-inn-aa	-COP/PROG-1PL-REM
-št-inn-ee	-COP/PROG-1PL-PRES
-št-ir	-PROG-3SG
-št-ir-im-aa	-PROG-3SG-1SG-REM
-št-ir-im-ee	-PROG-3SG-1SG-PRES
-št-ir-imaan-aa	-PROG-3SG-1PL-REM
-št-ir-imaan-ee	-PROG-3SG-1PL-PRES
-št-ir-ir-aa	-PROG-3SG-2SG-REM
-št-ir-ir-ee	-PROG-3SG-2SG-PRES
-št-ir-iraan-aa	-PROG-3SG-2PL-REM
-št-ir-iraan-ee	-PROG-3SG-2PL-PRES
-št-ir-is-aa	-PROG-3SG-3SG-REM
-št-ir-is-ee	-PROG-3SG-3SG-PRES
-št-ir-isaan-aa	-PROG-3SG-3PL-REM
-št-ir-isaan-ee	-PROG-3SG-3PL-PRES
-št-ir-m-aa	-PROG-3SG-1SG-REM
-št-ir-m-ee	-PROG-3SG-1SG-PRES
-št-ir-maan-aa	-PROG-3SG-1PL-REM
-št-ir-maan-ee	-PROG-3SG-1PL-PRES
-št-ir-r-aa	-PROG-3SG-2SG-REM
-št-ir-r-ee	-PROG-3SG-2SG-PRES
-št-ir-raan-aa	-PROG-3SG-2PL-REM
-št-ir-raan-ee	-PROG-3SG-2PL-PRES
-št-ir-s-aa	-PROG-3SG-3SG-REM
-št-ir-s-ee	-PROG-3SG-3SG-PRES
-št-ir-saan-aa	-PROG-3SG-3PL-REM
-št-ir-saan-ee	-PROG-3SG-3PL-PRES
-št-is-m	-PROG-3SG-1SG
-št-is-m-aa	-PROG-3SG-1SG-REM
-št-is-m-ee	-PROG-3SG-1SG-PRES
-št-is-maan	-PROG-3SG-1PL
-št-is-maan-aa	-PROG-3SG-1PL-REM
-št-is-maan-ee	-PROG-3SG-1PL-PRES
-št-is-r	-PROG-3SG-2SG
-št-is-r-aa	-PROG-3SG-2SG-REM
-št-is-r-ee	-PROG-3SG-2SG-PRES
-št-is-raan	-PROG-3SG-2PL
-št-is-raan-aa	-PROG-3SG-2PL-REM
-št-is-raan-ee	-PROG-3SG-2PL-PRES
-št-is-s	-PROG-3SG-3SG
-št-is-s-aa	-PROG-3SG-3SG-REM
-št-is-s-ee	-PROG-3SG-3SG-PRES
-št-is-saan	-PROG-3SG-3PL
-št-is-saan-aa	-PROG-3SG-3PL-REM
-št-is-saan-ee	-PROG-3SG-3PL-PRES
-št-iss	-COP/PROG-2PL
-št-iss-aa	-COP/PROG-2PL-REM
-št-iss-ee	-COP/PROG-2PL-PRES
-št-m-ir-aa	-PROG-1SG-2SG-REM
-št-m-ir-ee	-PROG-1SG-2SG-PRES
-št-m-iraan-aa	-PROG-1SG-2PL-REM
-št-m-iraan-ee	-PROG-1SG-2PL-PRES
-št-m-is-aa	-PROG-1SG-3SG-REM
-št-m-is-ee	-PROG-1SG-3SG-PRES
-št-m-isaan-aa	-PROG-1SG-3PL-REM
-št-m-isaan-ee	-PROG-1SG-3PL-PRES
-št-om	-COP/PROG-1SG
-št-om-aa	-COP/PROG-1SG-REM
-št-om-ee	-COP/PROG-1SG-PRES
-št-om-ir-aa	-PROG-1SG-2SG-REM
-št-om-ir-ee	-PROG-1SG-2SG-PRES
-št-om-iraan-aa	-PROG-1SG-2PL-REM
-št-om-iraan-ee	-PROG-1SG-2PL-PRES
-št-om-is-aa	-PROG-1SG-3SG-REM
-št-om-is-ee	-PROG-1SG-3SG-PRES
-št-om-isaan-aa	-PROG-1SG-3PL-REM
-št-om-isaan-ee	-PROG-1SG-3PL-PRES
-št-om-r-aa	-PROG-1SG-2SG-REM
-št-om-r-ee	-PROG-1SG-2SG-PRES
-št-om-raan-aa	-PROG-1SG-2PL-REM
-št-om-raan-ee	-PROG-1SG-2PL-PRES
-št-om-s-aa	-PROG-1SG-3SG-REM
-št-om-s-ee	-PROG-1SG-3SG-PRES
-št-om-saan-aa	-PROG-1SG-3PL-REM
-št-om-saan-ee	-PROG-1SG-3PL-PRES
-št-or	-COP/PROG-2SG
-št-or-aa	-COP/PROG-2SG-REM
-št-or-ee	-COP/PROG-2SG-PRES
-št-or-im	-PROG-2SG-1SG
-št-or-im-aa	-PROG-2SG-1SG-REM
-št-or-im-ee	-PROG-2SG-1SG-PRES
-št-or-imaa	-PROG-2SG-1PL
-št-or-imaan	-PROG-2SG-1PL
-št-or-imaan-aa	-PROG-2SG-1PL-REM
-št-or-imaan-ee	-PROG-2SG-1PL-PRES
-št-or-is	-PROG-2SG-3SG
-št-or-is-aa	-PROG-2SG-3SG-REM
-št-or-is-ee	-PROG-2SG-3SG-PRES
-št-or-isaa	-PROG-2SG-3PL
-št-or-isaan	-PROG-2SG-3PL
-št-or-isaan-aa	-PROG-2SG-3PL-REM
-št-or-isaan-ee	-PROG-2SG-3PL-PRES
-št-or-m-aa	-PROG-2SG-1SG-REM
-št-or-m-ee	-PROG-2SG-1SG-PRES
-št-or-maan-aa	-PROG-2SG-1PL-REM
-št-or-maan-ee	-PROG-2SG-1PL-PRES
-št-or-s-aa	-PROG-2SG-3SG-REM
-št-or-s-ee	-PROG-2SG-3SG-PRES
-št-or-saan-aa	-PROG-2SG-3PL-REM
-št-or-saan-ee	-PROG-2SG-3PL-PRES
-št-r-im-aa	-PROG-3SG-1SG-REM
-št-r-im-ee	-PROG-3SG-1SG-PRES
-št-r-imaan-aa	-PROG-3SG-1PL-REM
-št-r-imaan-ee	-PROG-3SG-1PL-PRES
-št-r-ir-aa	-PROG-3SG-2SG-REM
-št-r-ir-ee	-PROG-3SG-2SG-PRES
-št-r-iraan-aa	-PROG-3SG-2PL-REM
-št-r-iraan-ee	-PROG-3SG-2PL-PRES
-št-r-is-aa	-PROG-3SG-3SG-REM
-št-r-is-ee	-PROG-3SG-3SG-PRES
-št-r-isaan-aa	-PROG-3SG-3PL-REM
-št-r-isaan-ee	-PROG-3SG-3PL-PRES
-t	-DAT
-t-à	-PFV-3SG
-it-à	-PFV-3SG
-t-aa	-PFV-REM
-t-een	-PFV-1PL
-t-eenaa	-PFV-1PL-REM
-t-eend	-PFV-3PL
-eend	-3PL
-eend-aa	-3PL-REM
-eend-ee	-3PL-PRES
-eend-imaa	-3PL-1PL
-eend-is	-3PL-3SG
-t-eend-aa	-PFV-3PL-REM
-t-ees	-PFV-2PL
-t-ees-aa	-PFV-2PL-REM
-t-om	-PFV-1SG
-t-om-aa	-PFV-1SG-REM
-t-or	-PFV-2SG
-t-or-aa	-PFV-2SG-REM
-t-os	-PFV-3SG
-t-ind	-PFV-3PL
-ta	-DAT
-tà	-DAT
-ttà	-DAT
-tar	-COMP
-tii	-2SG.IMP
-itii	-2SG.IMP
-tt-à	-PFV-3SG
-tt-aa	-PFV-REM
-tt-een	-PFV-1PL
-tt-een-aa	-PFV-1PL-REM
-tt-eend	-PFV-3PL
-tt-eend-aa	-PFV-3PL-REM
-tt-ees	-PFV-2PL
-tt-ees-aa	-PFV-2PL-REM
-tt-om	-PFV-1SG
-tt-om-aa	-PFV-1SG-REM
-tt-or	-PFV-2SG
-tt-or-aa	-PFV-2SG-REM
-va	-VERS
-vaa	-VERS
-vaar	-SIM
-ivaar	-SIM
-ya	-INDEF
-yaa	-VITR/INDEF/3PL/REM/and/2SG
-yaa-r-ee	-VITR-3SG-PRES
-yaa-r-aa	-VITR-3SG-REM
-yaan	-3PL
-yee	-PRES
-yi	-OBL.SG
-yiin	-PL
-yin	-OBL.PL
-yiš	-DER
-yis	-3SG/2PL/OBL.SG/2PL.IMP
,	**
:	**
!	**
?	**
.	**
!?	**
aaġa	master
aal	instrument
aalà	instrument
aalee	instrument
aamin	believe
aamin-	believe
aan	egg
ààn	end/most
aan-	bring
aan	bring
aann-	bring
aanà	egg
aansee	female.teacher
aanseey	female.teacher
aar-	between
ààr-	between
ààr-osaa	between-3PL
ààr-osaan	between-3PL
ààr	between
aaree	yes
aree	yes
aaṭ	flour
aaṭà	flour
aaṭee	flour
aav-	come
aam-	come
aa-	come
aa-mm-aa	come-1SG-REM
aaviččis	you.all.come
aaviin	mirror
aaviinà	mirror
aaviindà	the.coming
aaviinee	mirror
aaxir	end
aaxirč	last
aaxirčim	at.last
ab-	for
ab-om	for-1SG
ab-omaa	for-1PL
ab-omaan	for-1PL
ab-or	for-2SG
ab-oraa	for-2PL
ab-oraan	for-2PL
ab-os	for-3SG
ab-osaa	for-3PL
ab-osaan	for-3PL
-osaa	-3PL
-osaan	-2PL
abadan	never
abo-	for
abom	for.me
abomaa	for.us
abor	for.you.SG
aboraa	for.you.PL
abos	for.him
afḍal	better
ag	fire
agor	horse
agorà	horse
aḥad	Sunday
ahil	family
ahl	family
aḥla	nicer
ahliiy	relations
aḥsan	better
aḥyaanan	sometimes
aḥyaan	sometimes
aj	today
ajà	today
ajjir-	rent
ajnab	foreigner
ajnabii	foreign
ajokà	today's.smt
ajontii	today
ajotii	today
ajotiinii	today
akaan	awake
akaan-	wake.up
akaanr-	wake.up
akan	farm
aki-	wait
akii	eye
aky	eye
akii-	wait
akiid	of.course
akk	eye
aklaat	candy
aktar	more
alčaaġ	low
alf	thousand
alif	thousand
alkee	lie
allah	God
allahà	for.the.God
allii	REL
almaanyaa	Germany
almohom	importantly
amaa	1SG
amaa-	1SG
amaakaašii	at.me.too
amaan	safety
amaariin	1PL
amaas	I.REFL
maas	I.REFL
ameen	I.EMPH
meen	I.EMPH
-en	EMPH
amiin	1PL
miin	1PL
amiiš-	descent
miiš-	descent
amiš-	descent
miš-	descent
amišo-	descent
ammat	people
amriikyaa	america
aneehaanii	like.this
aniišik	elbow
aqal	less
aqalla	less
aqallaššii	at.least
aqil	brain
aqqor	nut
aqrab	closest
araa	boy.VOC
araaṭ	night
arbaḥ	lucrative
arbiiʕaayà	Wednesday
arčiq-	smash
arḍ	earth
arj	early.morning
arzaan	cheep
aš-ee	there.is-PRES
asaas	base
aṣil	origin
aškara	clear
aškaraa	clear
aṣl	origin
asmar	dark
ašqar	blond
asraʕ	faster
ašt-	there.is
ašt-aa	there.is-REM
ašt-ee	there.is-PRES
aštee	there.is
avindà	arrival
awaṣaar	summer
away	yes
awqaat	sometimes
awwal	first
awwaal	first
awal	first
awaal	first
awwalan	firstly
awwalii	past
awaalii	past
axar	stream
axḍar	green
axxir	late
axxir-	be.late
ay-	come
ayaẓ	star
ayba	dad.VOC
aybaa	dad.VOC
ayda	mom.VOC
ayyaa	any
ayya	any
aza	if
aẓin	I.think
azraq	blue
b-	with/at/fear-
bààb	father
bààbee	father
bààboraa	your.father
baajaan	aubergine
baalv	bracelet
baalvà	bracelet
baanjaan	aubergine
bààr	bar
baar	brother
baar-	outside
baarà	outside
baaṣ	bus
baaṣ-	at
baaṣ-yaa	at-3PL
baaṣ-ii	at-3SG
baaṣ-om	at-1SG
baaṣ-or	at-2SG
baaṣ-omaa	at-1PL
baaṣ-oraa	at-2PL
baaṣ-omaan	at-1PL
baaṣ-oraan	at-2PL
baašilġ	dowry
baašliġ	dowry
baaṭron	trousers
baav	portion
baavlà	bracelet
baaẓaar	weekend
baaẓaarintà	on.the.weekends/on.fridays
babbor	heater
badaal	instead
baddil-	change
baḍʕà	goods
bahdal-	humiliate
bahdil-	humiliate
bahdir-	humiliate
baḥr-	sea
baḥr	sea
bakir	sheep
bakr	sheep
bakkiir	early
bala	let
balamaʕna	meaningless
baljiika	Belgium
baljiikya	Belgium
baljiikyaa	Belgium
balliš-	start
bališ-	start
ballor	glass
ban	shut
ban-	shut
banḍuura	tomato
banj-	break
banjii-	be.broken
bar-	travel
barakà	blessing
bard	full
bard-	full
barḍà	full
barḍ-	full
barfuubaaraan	thunderstorm
barfobaaraan	thunderstorm
bariid	postcard
barraakiiy	tent
barraakiiyà	tent
barraakiiyee	tent
bas	but/enough/only
bašar-	skin
bašarà	skin
baṣiiṭ	simple
bassee	enough
baṭaaṭà	popato
baṭaaṭee	potato
baṭṭaa	goose
baṭṭaaniiy	blanket
baṭṭaaniiyà	blanket
baṭṭaaniiyee	blanket
baṭṭaaniiyyee	blanket
baṭṭaaniy	blanket
baxšiiš	tip
bayyaaʕ	seller
baʕḍ-	same
baʕḍo	same
baʕdeen	after
baʕdeend	after
baʕid	after
baʕiḍ	some
baʕidma	after
baʕadma	after
baʕidmaa	after
baʕadmaa	after
bdee	give
bdee-	give
bidy-	give
bdiilà	exchange
bdunmaa	without
bduunma	without
bduunmaa	without
beefkà	other
beefkii	other
beelii	friend
beely	friend
been	sister
beevkà	other
bi-	with/at/fear-
bidʕa	heresy
bii-	fear-
biibii	aunt
biiby	aunt
biir	mind
biiraa	beer
biiš	fear
bijib	with.tonque
bijj-	give
bil	hip
bil-	in
bil’ajaar	rented
bilaxiir	finally
axiir	end
bilḥaqiiqa	realistically
leel	night
biltawaaṣiil	consecutively
bilʕaadee	normally
bimil	expensive
binnisbee	acording
biqwat	strong
birjuuʕ	in.return
bis	straw
biskilleet	bicycle
bissalaamee	safely
bissaalaamee	safely
biyaa-	be.scared.of
bizmaar	nails(metals)
biẓẓabit	exactly
biẓẓabiṭ	exactly
biẓẓabit	exactly
biʕid	far
biʕiṣ-	finger
bkuun	maybe
blaav-	share
bliš-	feud
blš-	feud
bn-	under
bnà	under
bn-aa	under-REM
bn-om	under-1SG
bn-or	under-2SG
bn-os	under-3SG
bn-omaa	under-1PL
bn-omaan	under-1PL
bn-oraa	under-2PL
bn-oraan	under-2PL
bn-osaa	under-3PL
bn-osaan	under-3PL
bnaan	Lebanon
bnee	under
bojii	dog
bojj	dog
boj	dog
bol	wide
boš	for.nothing
boṭ	boot
boya	shoe-shining
boydaaġ	temporary
bribiʕ	quarterly
briin	wound
briin-	injure
briinj	rice
briinkar-	injure
bu	a.lot.of
buqwat	strong
buqwat-	strong
buttar	more.than
buu	much
buurii	tube
buut	a.lot
byaa-	fear
byaav-	fear
čaadir	thick.fabric
čaaġ	child
čaaġ-	child
čaaġà	child
čaaġa	child
čaaġee	child
čaaġvaayà	childhood
čaaġvaayaa	childhood
čaaġvaačč	childhood
čaakeet	jacket
čaakeetà	jacket
čaan	cheek
čaap	left
čaar	hide
čààr-	hide
čaaṭik	cloak
čaaṭk	cloak
čaay	tea
čakk-	strong/courageous/hard
čakkà	hard
čakkuuš	hammer
čanaq	saucer
čanč	next.to
čanč-	next.to
čanč-om	next.to-1SG
čanč-omaa	next.to-1PL
čanč-omaan	next.to-1PL
čanč-or	next.to-2SG
čanč-oraa	next.to-2PL
čanč-oraan	next.to-2PL
čanč-os	next.to-3SG
čanč-osaa	next.to-3PL
čanč-osaan	next.to-3PL
čanii	earring
čany	earring
čaniy	earring
čanṭaay	bag
čanṭaayà	bag
čany	earring
čap	left
čar-	drive
čatiin	difficult
čatiin-	difficult
čaynà	trousers
čayn	trousers
čaynee	trousers
čee	as.you.say/it.is.like
čeesik	boy
čeesk	boy
čeezik	boy
čiit	veil
čiknaa-	fasten
čil	fourty
čin-	cut/cross
čiri	knife
čirii	knife
čiry	knife
čišt-	say
čiṭ-	jump
člo	leaf/peel
čmaarii	hen/chicken
čmaary	chicken
čonà	orphan
čoraab	sock
čorm	around
čorm-	around
čormin	around
čraakii	light
čuut	both/couple.of
čuut-	abort
čwaal	sack
čxin	repository
d-	give
dà	so
-dà	-so
daa'iiman	always
daad	mother
daadii	grandmother
daady	grandmother
daady-	grandmother
daadj	grandmother
daadj-	grandmother
daadč	grandmother
daaliiz	corridor
ḍaam	castle/stone.house/room
daamlà	cover
daaml-	cover
daasṭrin	thirteen
daav	thread
daav-	run
daavir-	run
ḍaawaṭ	wedding
daaxlii	inner
daayim	always
daayman	always
daa’iiman	always
daayiq-	annoy
dabbir-	manage
daftar	notebook
dahhin-	paint
dahhin-kar-	paint
dahliiz	corridor
daḥv-	run
dak-	see
k-	do/make
dakkii-	see
dakk-	see
daktor	doctor
dammir-	destroy
dand	tooth
dand-	tooth
dandii	seed
dangiz	sea
daq	tattoo
daqq	minute
daqqà	minute
daqqee	minute
daraadiiʕ	unuseful.things
daraj	stairs
darajà	stairs
ḍarb	hitting
ḍarbà	hitting
dardiš-	converse
dars	lesson
darzan	dozen
daspanj	fifteen
daššeeš	sixteen
dašt	field
dastà	dozen
dastaar	mill
davà	camel
dav	camel
ḍaw	light
ḍaww	light
ḍawaṭ	wedding
day	because
daynak	stick
ḍayyif-	host
daz	ten
dazdidii	twelve
dazdii	twelve
dazḥašt	eighteen
dazḥawt	seventeen
daznah	nineteen
dazyeekaa	eleven
ḍaʕiif	weak
ḍaʕiif-	weak
daʕwà	invitation
dee	give
dee-	give
deer	Deir.ez-Zur
deerii	Of.Deir.ez-Zur
deeš-	from
deeš-omaan	from-1PL
deeš-oraan	from-2PL
deeš-omaa	from-1PL
deeš-oraa	from-2PL
deeš-ii	from-3SG
deeš-yaa	from-3PL
dḥim-	push
ḍib-	embrace
ḍiḍ	against
didà	and.so.on
didii	two
didiin	two
didyiin	two
didy	both
difiš-	push
difiʕ	pay
difiʕ-	pay
difiʕkar-	pay
digim-	bind
diḥim-	push
dihin-	paint
dii	village/two
diib	wolf
diin	religion
diis	day
diisaadii	one.more.day
diisadii	one.more.day
diisadirmii	one.more.day
diisivaayee	days.ago
diiṭrin	a.few
diitrin	a.few
tiiṭrin	a.few
diivaar	wall
diiwaan	gathering
ḍiiʕ-	get.lost
dik-	hurt
dikkaan	shop
diknaa-	hurt
diknaav-	hurt
diktoor	doctor
diktor	doctor
diktora	doctor.F
dinya	world
dinyaa	world
dinyee	world
dinyaay	world
dir	again
dir-	prolong
ḍir-	rip
dirg-	long
diris-	study
diriskar-	study
dirj	drowers
dirmà	again
dirmii	again
dišk-	paste
d-išt-	give-PROG-
diy	village
diyà	village
diyaar-	obvious
do-	wash
do	wash
ḍol	drum
dolaar	dollar
ḍom	Dom
ḍom-	Dom
ḍomà	Dom
dongiz	pig
dongizà	pig
dor	period
dormačaar	around
došak	mattress
dow-	wash
dow	wash
dowii-	be.washed
draar-	be.full
draarà	full
dris-	study
drong-	old/big
drong	old/big
drongg-	old/big
duk-	hurt
dukkaan	shop
dukkan	shop
dukn-	pain
duknaa-	hurt
duktor	doctor
duktora	doctor.F
duktoraa	doctor.F
duudii	smoke
duudy	smoke
duul	sand
duular	dollar
duun-	without
duun-om	without-1SG
duun-or	without-2SG
duur	far
duur-	turn.around/far
duwweera	circle
dva	crowd
dvaa	amount
dy	village
dyaar-	appear 
dyi	village
ee	this
eef	this
eeaanii	thus
eefaanii	thus
eefaan	thus
eefaan-	thus
efaanii	thus
eehaanii	thus
eehaani	this
eehaan	this
eejaak	food
eejak	food
eer	this
eeriin	these
eerin	these
eeris	this
eeta	here
eetaa	here
eetee	here
eevaarà	evening
f-	say
faal	fortune
faatqà	story
faḍḍil-	prefer
faḍḍilkar-	prefer
faḥḥim-	cry
faj'a	suddenly
fakkir-	think
falasṭiin	Palestine
faqiir	poor
faqiir-	poor
faraḍna	presumably
farḍ-	obligatory
fariḍ-	obligatory
fariq	diffrence
farriq-	separate
farwà	fur
farwee	fur
fasaad	corruption
fasḥà	space
fasḥ	space
fisḥ	space
fatrà	period
fatr	period
fatuun	above
fawran	immediately
faxuur	proud
faxuur-	proud
fik-	sell
fikin-	sell
fkin	sell
fkin-	sell
fikinyaa-	be.sold
fikn-	sell
fikn	sell
fim-	understand
fimm-	understand
fimmo-	understand
finḍik	mucus
finjaan	coffee.cup
fiqid-	lose
fiqir	poverty
fiqr	poverty
fir-	fly
firiḍ-	assume
firin	oven
firm	bakery
firn	oven
firṣà	chance
fistaq	nut
fiṭir	mushroom
flaan	someone
foq	above
fqaar-	poor
fqaaree	poor
friḍ-	assume
friḥ-	be.happy
ft-	say.PFV
fuṭuur	breakfast
ga-	go
gaa	good
gaa-	say/good
ġaab	forest
ġaabà	forest
ġaabee	forest
gaah	good
gaal	word
gaal-	word
gaam	sunset
ġaamiḍ	mysterious
ġaamiq	dark
ġaamir-	use
gaan	smell
gaar-	say/good
ġaariib	strange
gaartar	better
gaas	grass
gaatto	cake
gaay-	good
gaay	good
ġaaz	gas
ġabi	stupid
ġabrà	dust
ġada	lunch
ġadaa	lunch
ġadaay	lunch
ġaddii-	have.lunch
gaj	non.Dom.man
gajà	non.Dom.man
gajee	non.Dom.man
gajja-	go-
gajjaa-	go-
gajjii	non.Dom.woman
gajji	non.Dom.woman
gajj	non.Dom.man
gajuunà	non.Doms
gajuun	non.Doms
gajuunkeeree	for.the.strangers
ġalaṭ	wrong
ġalaṭ-	wrong
gallaabiiyà	dress
gallaabiiyee	dress
gałłaabiiyee	dress
gałłaabiiyà	dress
garà	went
ġarb	west
ġariib	strange
ġarib	strange
gavr-	clean
gavrà	clean
gavri-	clean
ġawa	make-up
ġayyir-	change
ġdir-	betray
ġidir-	betray
geen	again
geen-	again
geena	again
geenaa	again
geenii	again
ġeer	diffrent
geesiv	wheat/rye
geetaa	there
geetaa-	there
giitaar	guitar
gildà	sweet
ginnà	fault/sin
gir	butter
girdaan	necklace
girdaan-	necklace
ġirfà	room
girg	neck
girgirtii	lightning
girt-	collect
girt-kar-	collect
ġiš-	cheat
gištarii	ring
gištary	ring
gištar	ring
git-	collect
giz-	bite
gluulik	flower
gluulk	flower
gog	spring
gogà	spring
gon	bag
gonà	bag
gordlarà	soldier
gorim	sister-in-law
goriv	cow
gorm	sister-in-law
gorv	bull
gorvà	bull
gorvi	bull
gorvi-	bull
gosà	dung
ġoṭiiš	sunset
greevaarà	nobleman
greevaar	nobleman
greevaar-	noble
guldà	sweet
guld-	sweet
guldwaanii	sweets
guldwanii	sweets
gunnà	fault
gunnee	fault
gunn-	fault
gunn	fault
gurdaan	necklace
gurdan	necklace
gurg	neck
gurgurtii	lightning
gurk	wolf
gurk-	wolf
gurkà	wolf
guštarii	ring
guštary	ring
guštaty	ring
h-	become
ha	there/this.one
haa	this
haadii	calmful
ḥaadir	actually
ḥaadis	accident
ḥaal	condition
ḥaalat	sieve
haanii	like.this
ḥaarà	neighbourhood
ḥaar	neighbourhood
ḥaas-	like
ḥaaskar-	like
ḥaat-	heal
ḥaawil-	try
haayee	it.is.this
ḥabbaasà	hair.claw
ḥabis	prison
ḥabs	prison
ḥabis-	prison
haddid-	threaten
haddii-	calm.down
ḥadiid	iron
ḥadiis	conversation
ḥadiiqà	garden
ḥadiiqee	garden
hadoba	at.least
ḥaflà	party
ḥaflee	party
ḥaj	pilgrimage
ḥalab	Aleppo
ḥalam	Aleppo
ḥalabii	pistachio
ḥalapillii	of.Aleppo
ḥaliib	milk
ḥamdillah	thank.God
ḥammaam	washroom
ḥaẓaar	thousand
han	take
han-	take
hana	this
hanaa	this
hanaa-yee	this-PRES
haneehaanii	thus
haneeriin	these
haniisim	now
haniita	here
hankeeta	here
hanorà	of.that
hanoriin	those
hanuu	that
ḥaq	truth
ḥaqiiqii	real
har	every/you.VOC
haraak	each
haraakà	each
haraakkii	each.GEN
ḥarakà	movement
ḥarakaat	movements
ḥarb	war
harḍa	this.much
ḥarf	letter
ḥarfa	letter
harja	fun
harkam	everything
harmaa	anytime
harma	anytime
harrib-	smuggle
ḥas-	like
ḥaša	except
ḥasab	according
ḥask-	chase
ḥaskar-	like
ḥaskariiš	love
ḥaṣṣaadà	harvest
ḥaṣṣaadee	harvest
ḥassiirà	rag
ḥašt	eight
hatta	until
ḥatta	until/even
ḥaṭṭa	until/even
ḥitta	until/even
ḥatti	as
hattii	as
ḥattii	as
hawiiyà	ID-card
ḥawt	seven
ḥawṭ	seven
ḥawtà	seventh
ḥawwil-	move
ḥawwir-	move
hay	something
hay-	something
ḥayaat	life
hayf	moon
hayyin-	easy
haz	yet
hazà	yet
ḥaẓaar	thousand
hazii	yet
hdii-	calm
ḥduud	border
ḥduu	border
hee	like.this
heeč	never
ḥfaaḍà	diaper
ḥfir-	dig
hi-	become
ḥiḍin-	hug
ḥiḍir	watch
ḥikim	govern
ḥikm-	govern
ḥikyaat	fairytale
him	both
him-	care
ḥimiṣ	homs
ḥimṣi	homs
ḥimṣi-	of/from
hind	India
hingaaryaa	Hungary
hingwiin	honey
ḥinniiyà	compassion
ḥir	free
ḥirf-	corner
ḥis-	feel
ḥiss-	feel
ḥuss-	feel
hiṣṣo-	shut.up
ḥit	until
ḥizir	guess
ḥizir-	guess
ḥlaaqa	shave
ḥmra	lipstick
ho	that.way
ho-	become
horee	maybe
ḥoš	house
hr-	become
ḥsaab-	calculate
ḥsaabkar-	count
ḥṭaaṭii	headgear
ḥṭaatiiyà	headgear
ḥukim	government/judge
ḥukm	government/judge
ḥukom	government
humbirgil	hamburger
ḥur	free
ḥurr	free
ḥurriiy-	freedom
huu	that
huuča	then
huučaa	then
huurd-	smooth
huurt	ground
ḥuus-	go.around
huušii	while
huwwa	that.way
huwwaa	that.way
huwwee	which
ḥwii-	hold
idṭir-	be.forced
iḥtiifaal	celebration
iḥtiifaala	celebration
iḥtirim-	respect
iifil	clean
iifil-	clean
iiqaamà	residence
iiqaamee	residence
iiqaam	residence
iiraan	Iran
iis	now
iisà	now
iisim	now
iita	here
iitta	here
iiyaa	it
Iizaar	niqab
ijjaa	apart
il-	DEF-
l-	DEF-
il'aan	now
ilaḥyaan	the.time
ilḥaadii	individually
ilḥaaḍy	individually
ilḥamdillah	thank.God
illi	REL
illii	REL
iillii	REL
ilmhom	importantly
ilmohom	importantly
iltaaleet	third
iltihaab	inflammation
iltihab	inflammation
iltiqii-	meet
iltiqiiy-	meet
ilwaḥiid	only
ilxamisṭaʕiš	fifteenth
ilʕaafyee	thanks
imbaalii	I.thought
imbaark-	congratulations
imbiṣiṭ-	be.happy
ingil	finger
injaazà	pear
innaas	people
innee	not
innii	so.that
innuu	that
annuu	that
intiqaadaat	criticisms
intiqaad	criticism
intiqil-	move
intisib-	belong
inzeeta	from.here
inziʕij-	be.annoyed
inzorà	of
iqaamà	residence
Iqtiiṣaaḍ	economy
irdon	Jordan
ordon	Jordan
isboʕ	week
isbuuʕ	week
isluub	manner
isnuuʕ	week
issinee	the.year
sinee	year
išt-	stand.up
ištaal-	lift
ištaan-	lift
ištaał-	rise
istaaz	male.teacher
istaġrib-	be.shocked
istaqbil-	welcome
istaxdim	use
istaxdim-	use
istiqir-	settle
ištir-	stand
it-	give
ita	here
itee	here
itt-	give.PFV
tt-	give.PFV
itt-à	gave.PFV-3SG
ixtaar-	choose
ixtilif-	differ
xtilif-	differ
iyyee	the.one
iz	from
iz-	from
iza	if
izvagir	before
izvagirtar	before
j-	go
jy-	go
jà	go
ja-	know
jaa	apart
jaa-	go
jaa-n	go-1PL
jaaftir	groom
jaahiz	ready
jaakeet	coat
jaal	youth
jaald-	send
jaal-	send
jaan	know
jaan-	know/spray
jaann-	know
jaas	you.all.go
jalab	bad
jan-	give.birth
janaazà	funeral
janaazee	funeral
janawar	animal
jani-	be.born
janii-	be.born
jarri'r-	dare
jarri’-	dare
jav	wheat/rye
jaw	weather/rye
jaww	weather/rye
jawaaz	passport
jawlaa	around
jawwiz-	get married
jay-	go
jayaa	so.you.go
jayy-	go
jayyiiš	going
jazaa'eer	Algeria
jazaa’eer	Algeria
jazaayeer	Algeria
jazaa’ir	Algeria
jazaar	Algeria
jbaarii	compulsory
jeemiʕ	Mosque
jeenik	hair
jeenk	hair
jheez	clothes
jib	tongue
jib-	talk
jibii-	talk
jii	soul
jiil	generation
jimʕaayà	Friday
jin-	chop
jinjilik	bell
jinz	denim
jirsaa-	marriage
jirsaavii	marriage
jirsaavii-	marriage
jirsaaviir-	get.married.PFV
jirsaaviiyo-	get.married
jirsaaiiyo-	get.married
jirsaav-	get.married
jisir	bridge
jisr	bridge
jiv	flea
jivir	woman
jivr	woman
jivri	woman
jiyaa	apart
jmaand	pocket
jmiʕ-	gather
jimiʕ-	gather
jumʕaayà	Friday
juu	go
juu-	go
juujii	hedgehog
juujiikandà	hedgehog
juunyuuvaayee	since.June
juvir	woman
juvr	woman
jvir	woman
juwr	woman
jy	soul
jyaa	apart
jyee	go
ka-	do/make/FUT
ka-jjaa-	FUT-go
jjaa-	go
kaa	where/something/FUT
kaak	something
kaakà	something
kaaka	something
kaakaa	something
kaammor	something
kaamor	something
kaan	where/it.was/REL
kaanà	REL
kaanii	where
kaaniiyee	is.not
kaany-a	none-REM
kaany-aa	none-REM
kaany-ee	none-PRES
kaar-	boil
kààr-	boil
kààrii-	be.boiled
kaarnaa-	boil
kààrnaa-	boil
kaarsis	unemployed
kààry-	be.boiled
kaas	cup
kaasà	cup
kaašt	wood
kaaẓoẓ	soft.drink
kača	when/always
kačaa	always
kačapa	always
kačapaa	always
kaččal	bald
kačeetà	on.the.opposite.side
kačeetee	on.the.opposite.side
kačvaayee	long.time.ago
kaffil-	sponsor
kageetaa	where
kajjaa-	go.FUT
gijjaa-	go.FUT
kajj-	go.FUT
kakii	what
kakiiy	what
kaki	what
kaky	what
kakk	what.kind.of
kakkà	what.kind.of
kakk-ee	what-PRES
kakk-aa	what-REM
kam	work/thing
kam-	work
kamà	for.work
kamaa	a.thing
kamaak	a.thing
kamar	belt
kamit	about.the.thing
kamka-	work
kamkar-	work
kammil-	continue
kammor	a.work/a.thing
kan	ear
kanabaayà	sofa
kanbaayà	sofa
kanada	Canada
kandà	thorn
kandirgii	rabbit
kandirgiyà	rabbit
kannii	maybe
kanni	maybe
kapkeez	pretty/nicely
kapkeez-	pretty/nice
kar	FUT
kar-	do/make
kara	how.much
karaawiit	dresser
karam	generosity
karḍa	how.much
karḍ	how.much
karii	cooking.pot
kariim	generous
kart	card
karton	carton
kary	cooking.pot
kaša	when
kassiiḥ	paralyzed
kašt-	do.PROG
kat	how
katà	how
katir	how
kaṭna	fart
kaṭnii	fart
katr	how
katr-aa	how-REM
katr-ee	how-PRES
kawwin-	form
kay	what
kayaa	what
kayl	dress
kaylà	dress
kayyaa-	be.needed
kayya-	be.needed
kaʕak	biscuit
kee	what
keef	pleasure
keeha	how.much
keehaa	how.much
keek	cake
keel-	play
keell-	play
keen	who/whom
keer	BEN
keeree	for
kees	whose
keeska	with.whom
keeskii	whose
keessaa	with.whom
keeta	where
keetaa	where
keetaa-	where
keetaa-yee	where-PRES
keetaa-yaa	where-REM
keetaaišt-	where.is
keetaayee	where
keeva	where.to
keevaa	where.to
kiiva	where.to
kič	beard
kičmaar	old.man
kičmaarà	old.man
kičmaaree	old.man
kičmar	old.man
kiil	red.stone
kiilo	kilo
kiir	milk
kiis	bag
kiita	where
kiitaa	where
kiky	what
kilmaa	whenever
kilšii	everything
kilmillii	each
kimnaarà	bad
kin	exit
kin-	exit
kind-	exit
kinzee	where
kinzeeva	where.from
kinzeevaa	where.from
kirii	house
kirsiiy	chair
kirsiiyà	chair
kirvik	worm
kiry	house
kiry-	house
kiryimo-	be.at.home
kit-	throw
kt-	throw
kitib-	write
kitii	how.many
kivnaav-	bad
kivrik	worm
kn-	exit
kniisà	church
kniisee	church
ko	throw/who
ko-	throw
koč	convoy
kol-	dig
kom-	gather
komà	many
komà-	many
koma	many
komaa	many
komar	coal
komee	many
kopirtii	bridge
kopirty	bridge
koprii	bridge
kosii	curse
kosii-	swear
kotak	blow
kotir	bird
kov-	throw
kovyaa-	be.fallen
kow-	throw
kowii-	fall.PFV
kowišt-	throw.PRG
koyee	who.is.it
koy-ee	who-PRES
kr-à	do.PFV-3SG
kr-	do/make
kree	do.PFV.3PL
kreem	cream
krih-	hate
krii	house
krom	chrome
kšaal-	pull
ksee	why
ktaab	book
ktibkariiš-	write
ktii	how.many
ktii-	how.many?
kuč	beard
kučmaarà	old.man
kul	each
kil	each
kulk	nothing
kulka	nothing
kulkaa	nothing
kulmillii	each
kulwaaḥeed	each
kumčaarà	old.man
kumčaar	old.man
kumii	some
kund-	exit
kuri	house
kur	house
kurii	house
kurk	forgery
kurmaalo	more
kursiiy	bench/chair
kursiiyà	bench/chair
kury	house
kut-	throw
kuttuur	Jew/non-Muslim
kuufeera	hairdresser
kuufeeraa	hairdresser
kuukar	chicken/rooster
kuukr	puppy
kuukrii	puppy
kuutà	lame
kuuʕ	elbow
kuwa	nobody
kuwaa	anyone
kuwaark	hut
kuwaar	hut
kuwii-	iron
kwa	anyone
kwaa	anyone
kuwaak	anyone
kwaakosaan	anyone.of.them
kwaammor	anyone
kwammor	anyone
kwii-	iron
kyaammor	something
la	and
la-	fall
la'annii	because
la’nnii	because
la’anno	because
la’nnuu	because
la’annii	because
la'annuu	because
laa	and/mom.VOC
laaf	girl
laafč	girl
laafčii	girl
laaftii	girl
laaftiiy	girl
laak	girl.VOC
laamingà	thingy
laaqiiyo-	meet
laar-	worthy
laavč	girl
laavčii	girl
laavree	tree
laavt	girl
laavtii	girl
laavtiii	girl
laavtiiy	girl
laazim	necessary
laazim-	necessary
laazm	necessary
labbik-	be.nervous
ladà	look
lag-	fight
lagaan	casserole
lagiiš	fight
lagiiš-	fight
laḥaal	alone
laḥaala	alone.F
laḥaalii	alone.1SG
laḥaalkon	along.2PL
laḥaalna	along.1PL
laḥaalo	alone.M
laḥaalon	alone.3PL
laḥad	until
lahallaq	until.now
laḥḥiq-	catch
lahjà	dialect
lahj	dialect
laḥẓ	second/sudden
laḥẓà	second/sudden
lajjii-	be.shy
lajjiikar-	be.shy
lak-	see
lak	see
laka	sure
lakaa-	show
lakir-	see
lakk-	see
lakkii-	see
lakkir	see
lam	reunion
lamaaṣ	prayer
lamaaz	prayer
lambee	lamp
laš	body
las-	fall/flee
lasi-	be.fallen
lasr-	fall
lašt-	fall
lavarii	woman.VOC
lavr	tree
lavrà	tree
lavree	tree
law	if
leeree	ring
leeš-	from
lġii-	cancel
lḥeef	blanket
lḥf-	blanket
lhii-	be.busy
lhi-	be.busy
lḥiim-	weld
lḥiim	weld
libnaan	Lebanon
libs-	clothing
lif-	turn.around
liff-	go.around/turn.around
lilṣaraaḥa	honestly
limma	when
lamma	when
limmin	when
lissà	gums
livaal-	stupid
lo	if
lon	salt/color
lor-	red
luffo-	turn
luġà	language
luġee	language
luġ	language
luġat	language
luulik	knee
lvaa	open/hit
lvaa-	open/hit
livaa-	open/hit
livaa	open/hit
lvaal-	crazy
lvaar-	crazy
lvaaly-	crazy
lvaalvaatii	craziness
lzim-	be.needed
lizim-	be.needed
m	face
m-	face
maa	1SG
maaḍii	past
maaḍy	past
maakiin	machine
maakiinà	machine
maal	money
mààl	wealth
maam	uncle
mààm	uncle
maan	mind
maan-	stay/think
man-	stay
maani-	stay
maaniṣ	human
maannṣ	human
maans	human
maanṣ	human
maanṣi	human
maanṣiin	people
maar-	kill
maarsiidees	Mercedes
maaṣ	month
maasii	meat
maaṣonà	months.old
maaṣon	months.old
maaṣt	yogurt
maasy	meat
maasyee	meat
maayn	woman
maayn-	woman
maaynà	woman
maayna	woman
maaʕada	except
maaʕadaa	except
mabṣuuṭ	happy
mabṣuuṭ-	happy
mabṣuut	happy
mabṣuut-	happy
mad	sofa
maddà	carpet
maddee	carpet
madiin	town
madiinà	town
madiinee	town
madras	school
madrasà	school
madrasee	school
mafraq	corner
maġolyiin	Mongolians
maġol	Mongloian
maḥal	store
maḥall	store
maharrib	smuggler
maḥmal	cupboard
maktuum	non-registered
maktuum-	non-registered
makyij-	make.up
mal-	leave
maleek	king
malfaʕ	veil
malfuuf	cabbage
malik	king
malyon	million
malaayiin	million
man	bread
manà	bread
manaṣṣ	platform
mang-	want
mangg-	want
manga	mango
manggir-	want.PFV
mangi-	want
mangičča-	want
mangiiš-	beg
mangiš-	beg
mangiiškar-	beg
mangit-	want
mangitii-	want
manii	bead
manj	middle/half
manja	inside
manji	inside
manjii	inside
manjomaanmà	in.us
manṭaqà	area
manṭaq	area
manṭaqee	area
many	pearl
maqar	location
maqṭaʕ	section
maqʕad	seat
mar	funeral
mar-	die
marà	death/funeral
maraḍ	sickness
mareeḥ	friendly
marḥ	friendly
marḥ-	cheerful
marḥaba	hi
marḥalà	section
mariindà	dead
markazeet	veil
marr-	die
marra	time
marrà	time
masalan	example
masbaḥà	rosary
masiiḥii	Christian
masiiḥyee	Christian
maṣir	Egypt
maṣr	Egypt
maṣnaʕ	factory
massiḥ-	wipe
maṭbax	kitchen
matrag	pole
mawjuud	existing
mawjuud-	existing
maydaan	field
mazaalma	as.long.as
maʕaaš	pension
maʕaašar-	cohabitate
maʕaašarà	cohabitation
maʕalma	except
maʕd-	stomach
maʕdan	metal
maʕinnuu	although
maʕjuun	paste
maʕmal	factory
maʕna	meaning
maʕruuf	known
maʕruuf-	known
mdaas	slipper
meetor	motorcycle
meezar	daf
meh	face
menj-	inside
menj-ii	inside-3SG
mftaaḥ	key
mh	face
mharrib	smuggler
mḥil-	unavailable
mi-	die
mič	kiss
mič-	kiss
mičir-	kiss.PFV
miftaaḥ	key
miġreeb	Morocco
maġreeb	Morocco
miġrib	sunset
mih	face
muh	face
mo	face
miḥtaaj	needy
miḥtaaj-	need
miḥtarim	respectful
miiliilya	Melilla
miliilya	Melilla
miizaan	balance
mijnaa-	breastfeed
mik	leave
mik-	leave
mikassaraat	nuts
mikir-	leave.sth
miktii	slap/palm
mil	price
mil-	change
milik-	own
millat	clan
min	since
minis	man
minis-	get.married
minis-kar-	get.married
minlamma	since
mins	man
mins-	man
minsin	the.man
miqyaat-	guard
miqyaatkar-	guard
mir-	pass
mirr-	pass
mirtaaḥ	comfortable
mirtaaḥ-	comfortable
miṣfeeyà	sieve
miṣfeey	sieve
mišii-	be.resolved
misiry	money
miškil	problem
miškilà	problem
mašaakeel	problem.PL
misrii	money
misr	money
misry	money
mišṭ	magazine
mišt-	ill
mištaarii	it.is.said
mištašfa	hospital
mištašfaa	hospital
mištivaačč	ill
mištv-	sickness
mit'akkid-	sure
mit’akkid	sure
mitil	like
mitilma	like
mitl-	like
miṭrib	musician
mix	brain
mixtalif	diffrent
mixtilif	diffrent
mixṭilit	mix
mixx	brain
miʕdà	stomach
mk-	leave
mkir-	let
moḍà	fashion
mondar-	the.ones
mondarà	person
mozà	slippers
mr-	die.PFV
mr-à	die.PFV-3SG
mir-à	die.PFV-3SG
mr-ee	die.PFV-PRES
mir-	die
mraaqib	controller
mṣaafir	guest
mṣaafr	guest
mšaan	because
mṣawwir	photographer
msobiʕ	rectangular
mu'aqqat	temporary
mu'aqqit	temporary
mudiir	director
mudir	director
muġreeb	Morocco
muġrib	sunset
muġrub	sunset
muraajaaʕà	review
muraajaaʕ	review
muu	NEG
muund	REL
muundà	REL
muundii	REL
muusim	season
mʕaaš	wage
mʕorii	ant
n-	take/NEG-
nà	NEG
na	NEG
naa-	bring
naa	bring
naaḥyà	side
naam	name
naamuus	honor
naan-	bring
naaqir-	argue
naatii	fingernail
naawiq-	peek
nač-	dance
načir-	dance
naḍḍaar	glasses
naḍḍaarà	glasses
naḍḍar	glasses
nafis	same
nafs	same
nafsiiyà	spirit
nah	nine
tisʕa	nine
nak	nose
namma	when
nandir	dream
nandr	dream
nandr-	dream
nang-	enter
nangi-	enter
nang	enter
nannà	no
nanna’	no
naqqiš-	engrave
nar	male
narà	male
narn	man
narnà	man
narna	man
narnee	man
nas-	flee
naš-	flee
našt-	flee
naṣiib	destiny
nasnaa-	drive.out
nav-	find/search
navi-	search
navv-	new
naww-	new/now
naxa-	cover
naxaa-	cover
naxx-	cover
nay-	did.not.come
naʕal	gun
naʕam	yes
naʕil	iron/gun
nbiid	wine
nee	take
nee-	take
neeld-	bury
neeriin	these
neezik	near
ni-	NEG-
nifix-	swell
nii-	take
ny-	take
niihaa’iiyan	never
niilà	blue
niil-	blue
niim	half
niimii-	grab/hold
niimro	noon
niimron	noon
niir-	take
niiy-	be.arrested
niiyaa-	arrest
niiyy-	be.taken.away
nijmee	star
nijm	star
nik-	towards
nimmin	when
niskaafee	nescafe
niṭ-	jump
no-	not
noraa	it.would.not.happen
notii	do.not.be
nqil-	move
nwii-	intend
nziʕ-	ruin
o	that
očik	sleeve
očk	sleeve
oḍà	room
ogmiiš-	praise
oriin	those
orin	those
orip	silver
orip-	silver
or	that
oris	that.one
oroppa	Europe
oroppaa	Europe
orp	silver
orṭaaġ	partner
oṣar	medicine
ošt	lip
ota	there
otaa	there
otee	there
ozg	other
ozgà	other
ozkà	other
paa	self/come
paa-	come
paačik	thigh
paalgondà	barefoot
paanii	water
paanjaan	3PL
paanjii	3SG
paanjiin	3PL
paanjin	3SG
paany	water
paanyà	3SG
paapiir	grandfather
paaqir	copper
paar-	buy/scare
paarr-	buy/scare
paarč	piece
paarčà	piece
paarčaa	a.piece
paarii-	scared
paariigaan	moat
paariir-	scared
paarnaa-	scare.CAUS
paaryaa-	be.scared
paaṣ-	at
paaṣ-i	at-3SG
paaṣ-ii	at-3SG
paaṣ-om	at-1SG
paaṣ-omaa	at-1PL
paaṣ-oma	at-1PL
paaṣ-omaan	at-1PL
paaṣ-or	at-2SG
paaṣ-oraa	at-2PL
paaṣ-oraan	at-2PL
paaṣ-yaa	at-3PL
paaṣ-yaan	at-3PL
paaṣom	at.me
paaṣyaa	at.them
paaṣ-yee	at-3SG
paav-	come
paaw	REFL
paaw-os	REFL-3SG
paaw-osaan	REFL-3PL
paay	REFL
paay-	REFL
paay-om	REFL-1SG
paay-omaa	REFL-1PL
paay-omaan	REFL-1PL
paay-or	REFL-2SG
paay-oraa	REFL-2PL
paay-oraan	REFL-2PL
paay-is	REFL-3SG
paay-isaa	REFL-3PL
paay-isaan	REFL-3PL
paayk-	REFL.BEN
pačii	behind
pač	behind
pačy	behind
palaṣ	tent
panḍ	way
panii	camb
paniir	cheese
panj	five
panṣaḍ	five.hundred
par	fur
par-	wash
pardom	itinerant
pardomà	itinerant
paṣ-i	at-3SG
paṣ-ii	at-3SG
paṣ-om	at-1SG
paṣ-omaa	at-1PL
paṣ-omaan	at-1PL
paṣ-or	at-2SG
paṣ-oraan	at-2PL
paṣ-yaa	at-3PL
paṣ-yaan	at-3PL
pašim	wool
pašm	wool
paštar	after
patii	headgear
paty	headgear
pay	itself
paykeerà	for.himself
pčaa-	ask
pčaa	ask
pčaav-	ask
pčaaw-	ask
pčaa	ask
pči-	say
peen-	remove
peenjà	fifty
peer-	bring.back
peeraa-	bring.back
peeraavaa-	make.sbdy.return
peešii	fly(insect)
peešmeend	belt
peeṭ	belly/stomach
pi-	drink
pii	drink
pii-	drink
piili-	spread
piišikkee	it.is.for.drinking
piivaaz	onion
pinjik	tail
pir-	return
pr-	return
pirtii	return/then
pis	straw
piš-	expel
pišk-	tear
piškiirà	torn
piskilleet	bicycle
pišnaa-	expel
pišt	back
pišta	real
pištaa	real
piy-	drink
pkaal-	hungry
pkeez-	good/beautiful
pkeez	good/beautiful
pkees	good/beautiful
pn-	take
pin-	take
piny-	take
pnaar-	old
pnààr-	white
pnaarà	old
pnààrà	white
pnààr	white
pnee	take
pnee-	take
poliis	police
poṭ	fabric
prà	Kurd
priin-	injure
prin-	return
psiik	cat
ptaaʕ	goods
ptaaʕà	goods
puuḥaal	pregnant
puuḥaal-	pregnant
puutik	hair
py-	drink
qa-	eat
qaa-	eat
qaab	clothes
qaabilkar-	meet
qaabilo-	meet
qaaġat	letter/paper
qaaġaṭ	letter/paper
qaal-	black
qaanuun	law
qaap	door
qaapii	door
qaapy	door
qaaqaṭis	the.paper
qaar	penis
qaaršii	in.front/opposite
qaašik	spoon
qaat	layer
qaaṭ	pound/paper
qaayin	brother-in-law
qaayn	brother-in-law
qaayn-	brother-in-law
qaaż	kerosene
qaaẓ	kerosene
qabil	before
qabilma	before
qabuu	basement
qaby-	basement
qaby	basement
qaddim-	apply/get.closer
qadiiman	earlier
qadiimii	old
qadiim	old
qado-	such
qaft	thief
qaft-	grab/hold
qafṭ-	grab/hold
qaḥvà	coffee
qaḥvee	coffee
qaḥw	coffee
qaḥwà	coffee
qaḥwee	coffee
qal	leather/skin
qallid-	imitate
qalma	before
qalmaa	before
qalʕa	castle
qam-	eat
qamy-	eat
qamar	moon
qamiis	shirt
qan-	remove
qanj	throat
qanjii	throat
qannà	early.morning
qantar	so.many
qantara	so.many
qantaraa	so.many
qaplam	blanket
qaplamà	blanket
qar	donkey
qaraaġ	corner
qaraayb	relative
qaraaybiin	relative
qard	debt
qard-	borrow
qarib	near
qariib	near
qarit	on.donkey
qarrir-	decide
qaṣ-	mean
qaṣab	shiny.item
qatt-	sour
qattà	size
qatti-	become.sour.PFV
qav-	strong
qavii	strong
qavii-	strong
qavrà	spicy
qavt	thief
qavt-	grab/hold
qavy-	strong
qawii	strong
qawr	spicy
qawir-	spicy
qawr-	spicy
qawt	thief
qay-	eat/vomit
qayy-	eat/vomit
qaym-	eat
qaymii	eat.IMP
qayyiiš	food
qayš	food
qaʕweerà	corer
qfil-	lock
qibiḍ-	get
qidrat-	ability
qiḥir-	repress
qiič	foot
qiijaaġ	clothes
qiimat	value
qil	hat
qil-	ride
qilb-	flip
qilb-naa-	flip-CAUS
qilčir	so.he.rides
qinaʕ-	convince
qinḍaaġ	infant
qiniʕ-	convince
qiniʕkar-	convince
qir	boy
qirnik	corner
qiš-	sweep
qisiis	priest
qiṣnaa-	cut
qiṣ-	cut
qiṣṣ	story
qiṣṣà	story
qissiis	priest
qiṭ-	call
qit-	call
qiṭiġ-	short
qiṭṭiġ-	short
qiṭyaavčaa-	be.called
qiṭyaavtyaa-	be.called
qizii	sacrifice
qizy	sacrifice
qjaaġ	hug
qjaaġkar	embrace
qjiiboraan	storm
ql-	ride
qłaa-	put
qlaarà	Bedouin
qlaar	Bedouin
qleedà	necklace
qleedee	necklace
qleed	necklace
qleed-	necklace
qlib-	flip
qmaaš	fabric
qnḍaaġ	infant
qniinik	bottle
qniʕ-	convince
qočik	braids
qočk	horn
qočkà	horn
qol	arm
qolàbnà	armpit
qonš	neighbourhood
qonšii	neighbour
qr	boy
qreeč	dirt
qreeč-	dirty
qreeš-	dirty
qṣid-	mean
qsii-	be.hard
qsim	part
qṭ-	call
qṭaaʕà	piece
qṭaaʕ	piece
qublà	prayer.direction
qublaavii	Qubvlaasi
qublaavyi	Qubvlaasi
quḥ-	cough
quḥyaav-	cough
qul	hat
qul-	ride
qullorà	soldier
qulpirdà	soldier
qumjii	goldsmith
qumur-	annoy
qur	boy
qur	boy
qurnik	corner
quṭ-	call/knock
qut-	knock
quṭġ-	short
quuz-	bow
quwwà	strength
quzii	sacrifice
qzii	sacrifice
quzy	sacrifice
quzy-	sacrifice
quzii-	shout
qzeez	glass
qzii-	shout
qziinà	shout
r-	become
ra-	arrive
ra'y-	opinion
raabeeʕ	forth
raadyo	radio
raas	head
raasan	immediately
raatib	salary
raf-	walk
raḥḥib-	welcome
raḥmatillah	mercy.of.God
raqṣ-	dance
raš-	reach
raṣ-	reach
ras-	reach
rašt-	arrive.PROG
rašty-	arrive.PROG
rasuul	messenger
rav-	walk
raw-	walk
rbo-	its.quarter
rḥaat-	heal
rib	quarter
ribiḥ-	gain
riš-	spray
risaal	letter
risaalà	letter
risaalee	letter
risim-	paint
risimkar-	paint
rišk	flea
rizqà	livelihood
rojà	fasting
rojee	fasting
rov-	cry
row-	cry
ruusya	Russia
sà	all
ṣà	all
sa	if
ṣaa	all
ṣaadiq	honest
ṣaadiq-	be.honest
saafir	travel
saafir-	travel
saaġ	alive
saaġ-	alive
ṣaaġ	alive
ṣaaġ-	alive
ṣaaḥii	sober
saaḥir	witch
saaḥr	witch
ṣaalà	hall
ṣaalee	hall
ṣaal	hall
ṣaałà	hall
ṣaałee	hall
ṣaał	hall
saalf	story
saalfà	story
saalfee	story
saalf-	story
saaqiiyà	stream
saaqiiyee	stream
saaqin-	take.care.of
šaariʕ	street
saarmà	cabbage
ṣaarmà	cabbage
šaarʕ	street
šaaṭir	good/clever
saav-	be.lost
saavii	owner
saavy	owner
saaviir-	be.lost.PFV
saavnaa-	lose
saavyaa-	get.lost
šaawir-	consult
ṣaay	all
ṣaayeemaa	all.of.us
ṣaayeemaan	all.of.us
ṣaayiin	all
saaʕa	a.watch/hour
saaʕà	a.watch/hour
saaʕid	help
saaʕid-	help
šabaab	young.people
sabab	cause
šabbaak	window
šabbaakà	window
šabbaakee	window
sabʕa	seven
sač	true/right
sač-	true
sačč-	true
sačč	true
saččà	truth
ṣaḍ	hundred
ṣad	hundred
saddaajà	carpet
saddaajee	carpet
ṣaddiq	believe
ṣaddiq-	believe
ṣaf	class
šafaq	twilight
safar	travel
ṣafḥà	page
safiinà	boat
safr	trip
safree	trip
šahaadà	certificate
ṣaḥafii	journalist
ṣaḥafiiy	journalist
saḥḥaarà	basket
šaḥḥaaṭà	slipper
saḥrii	tomorrow
sajjil-	register
sak-	be.able
sakkaaf	shoemaker
šakkar	sugar
šakkil-	vary
sakraton	wardrobe
ṣal	rope
ṣallḥ-	repair
salli-	entertain
ṣalliḥ-	repair
sallim-	greet
sam	poison
sama	sky
samaa	sky
samaay	sky
skin	live
šamil	reunion
šaml	reunion
šamsiiyà	umbrella
šamsiiyee	umbrella
ṣandoq	box
ṣanduuq	box
šans	luck
sanṭa	attention
sappuurii	worm
saptà	Saturday
ṣaraaḥà	the.truth
šaraf	honor
šarq	east
šarraʕ-	rise
ṣarrif-	behave
ṣarrifoččaa	so.you.handle/act
šarriʕ-	lift
sarw	wealth
sarwà	wealth
ṣaṣ	sound/voice
šataat	diaspora
šattii	winter
ṣawwir	photograph
ṣawwir-	photograph
ṣaxir	rock
ṣaxr	rock
ṣaxr-	rock
šaxṣii	personal
ṣayṭarà	authority
sayyaar	car
sayyaarà	car
sayyaaree	car
saʕa	o'clock/watch/hour
saʕat	when/hour
saʕit	when
saʕtii	when
saaʕtii	when
ṣb	tomorrow/morning
ṣba	tomorrow/morning
ṣbà	tomorrow/morning
šbih-	resemble
sbuuʕ	week
sdaaj-	rug
seefà	apple
šeennig	people
seer	traffic
šeeš	six
šeeṭaan	satan
seewii	direct
šeex	sheikh
ṣib	tomorrow/morning
ṣib-	tomorrow/morning-
ṣibà	morning/tomorrow
ṣiba	tomorrow/morning
ṣibaa	tomorrow/morning
šibbaak	window
šibbakà	window
sii	cold
šii	too/thing
ši	thing
iššii	thing
sii-	cold/thirty
siikaarà	sigarette
siild-	cold
siin	breast
siinii	tray
siiny	tray
siiv-	sew
siivii-	be.sewn
siiy	cold
siiy-	cold
siiyaarà	car
siiyaaree	car
siiyeekaa	thirty.one
sijin	prison
sijq	sausage
sik-	learn
šikà	dry
šikil	kind.of/form
sikir-	be.drunk
šikkà	dry
sikkà	pole
šikl	form
siknaa-	teach
šikul	form
šikyaat	complaint
sim	hole
sin-	hear/knead
sin	hear/knead
sinyaa-	be.heared
sir	head/secret
sir-	happen
šird-	rise
ṣirfà	dining.place
ṣirf	dining.place
sitrà	decency
si-	sleep
si-tt-	sleep-PFV
sitt-	sleep.PFV
sitt-à	sleep.PFV-3SG
sitt-een	sleep.PFV-1PL
sittee	six
siv	needle
siv-	sleep
siyy-	cold
šjaaʕ	strong
škà	dry
šk- dry
škir-	thank
škirkar-	thank
slaa-	pay/make.sbdy.sleep
ṣlaal	winter
ṣlaalà	winter
ṣlaalee	winter
ṣliḥ-	reconcile
sm	hole
šmaal	north
sminkii	from.the.holes
sn-	hear
snaan	tooth
ṣo	all
ṣoba	stove
šobaaš	gift
ṣobba	stove
šorba	soup
šorbaa	soup
šorbaay	soup
ṣovin	gold
sowin	gold
ṣowin	gold
sown	gold
sown-	gold
sovin	gold
ṣown	gold
ṣoy	all
ṣoyiin	all
ṣoyinkii	from.all.of.them
spaanya	Spain
spaanyaa	Spain
ṣqaaq	street
sr	head/secret
sr-	head
štaal	lift
štaal-	lift
štaar	four
štaarviisdaz	ninety
štaarviist	eighty
štir-	stand
ṣṭoḥ	terrace
štr-	stand
štuun	pole
sukatiin	adhesive
šukil	form/kind
šukul	form
suppirmaarkeet	supermarket
suujin	needle
ṣuurat	picture
ṣuuraṭ	piture
suuriiya	Syria
suuryaa	Syria
suuriiyaa	Syria
ṣuusik	chick
ṣuwar	pictures
sv-	sleep
sviinj	mattress
ṣwaab	scourge
sweed	Sweden
šwii-	be.roasted
syaaḥa	trip
t-	give
t-om	give.PFV-1SG
t-or	give.PFV-2SG
t-os	give.PFV-3SG
d-eend-aa	give-3PL-REM
d-eend-ee	give-3PL-PRES
d-eend-imaan-aa	give-3PL-1PL-REM
t-om-isaan-ee	give.PFV-1SG-3PL-PRES
t-om-isaan	give.PFV-1SG-3PL
t-om-isaan-aa	give.PFV-1SG-3PL-REM
tà	DAT
ta	so/because/in.order.to
taa	so/because/in.order.to
ṭaabà	packet
ṭaajii	police.dog
taalii	second
taaly	second
taamat-	accuse
taan	place
taam	place
taaniiyan	secondly
taankii	which
taanmor	anyplace
taanmorit	at.any.place
taar	revenge
taarii	it.is.said
ṭaaṣ	bowl
ṭaaṭ	Arab
taav	place/bed
taaw	place
taaw-	place
ṭaawl	table
ṭaawlà	table
ṭaawlee	table
ṭaawliin	table.PL
ṭabiiʕii	normal
ṭabiʕ	habit
ṭabʕan	naturally
ṭabʕ	nature
ṭaffiš-	expel
taftiiš	inspection
ṭahhir-	purify
tahmat-	accuse
tajaarà	trade
tak	single
taliifoon	phone
tam	part
ṭama	part
tambal	lazy
tammoz	July
tammozim	in.July
tammuuz	July
tamnniiy	hope
tamnniiy-	hope
tan	piece
taneenà	Monday
tapš	plate
tapšii	plate
taqaaliid	traditions
taqriiban	approximately
ṭarn-	young/brave/handsome
ṭarwaal	sword
taskar	ticket
taskarà	ticket
taskaree	ticket
ṭaṭ-	hot
tatar	Tatars
ṭaṭhiir	cleansing
ṭaṭoṣar	pepper
tavnà	thin
tavn-	thin
tavn	thin
taxallof	backwardness
taxit	bed
ṭaxiṭ	bed
taxt	bed
ṭayyaarà	airplane
ṭayyaaree	airplane
tazwiir	forgery
taʕbaan	tired
taʕbaan-	tired
teen	you
teezik	boy
tfaḍḍal	please
tiffaaḥ	apple
tii	how.many
tii-	how.many
tiika	a.little
tiikaa	a.little
tikka	a.little
tiikaadii	a.little.more
tiimaar-	look.after
tiimaar	look.after
tiitik	slowly
tikaadii	a.little.more
ṭill-	become.big/big
ṭillà	fat
ṭil-	fat
ṭillaab	students
ṭind-	wet
ṭinḍ-	wet
tinteen	two.o'clock
ṭiq-	explode
tirbà	grave
ṭirin	three
tirkiiya	Turkey
turkiiya	Turkey
ṭirlamii	third
tirmiz	flask
ṭirnà	third.day
tirs	you
ṭiš-	scatter
tit-	give.PFV
tit-à	give.PFV-3SG
tit-om	give.PFV-1SG
tiya	a.little
ṭiʕij-	twist
ṭiʕin-	stab
tjaarà	trade
tjaaree	trade
ṭlib-	ask
tluub-	drip
tluup-	drip
tlob-	drip
ṭmaalii	soldier
tmaariin	you.pl
ṭmaaš-	watch
tmannii-	hope
tmiin	2PL
ṭnaʕiš	twelve
to	2SG
to-	put
ṭomrà	bag.of.fabric
ṭop	ball
ṭop-	fold
ṭopal	handicap
tošii	you.too
tov-	put
tow-	put
ṭoz	dust
tqliiyà	jug
traakii	dark
traaky	dark
ṭrambiil	car
ṭrimbiil	car
ṭirn	three
ṭrin	three
ṭrintan	three.of
ṭrinviisdaz	seventy
ṭrinviist	sixty
ṭroṭ-	small
ṭroṭ	small
ṭrot-	small
ṭrot	small
trotà	a.little
tuknà	Turkey
tutun	cigarette
tutuun	cigarette
tuuk	body.hair
tuunees	Tunisia
tuunis	Tunisia
tuuns	Tunisia
tuunsii	Tunisian
twaqqiʕ-	expect
ṭʕij-	bend
ṭʕijkar-	bend
ungil	finger
urdon	Jordan
urdin	Jordan
utee	there
uu	and
uujà	high
uuta	there
uutaa	there
uutee	there
uuta-	there
uutaa-	there
uutee-	there
va-	open/hit
vaa-	open/hit
vaal	hair
vaalà	empty
vaal-	empty
vaam-	hit
vaar-	leave
var-	leave
vaaraa	once
vaart-	leave
vaard-	leave
vaardee-	leave
vaarindy-	leave
vaarii	bride
vaari	bride
vaary	bride
vaaš-	with
vaaš-i	with-3SG
vaaš-ii	with-3SG
vaaš-om	with-1SG
vaaš-omaan	with-1PL
vaaš-omaa	with-1PL
vaaš-or	with-2SG
vaaš-oraan	with-2PL
vaaš-oraa	with-2PL
vaaš-yaa	with-3PL
vaaš-yaan	with-3PL
vaaš-šaan	with-3PL
vaat-	on
vaay	wind/air
vaayee	wind/air
vagir	in.front.of
vagirtar	before
vagr-	in.front.of
vagr-om	in.front.of-1SG
vagr-omaa	in.front.of-1PL
vagr-omaan	in.front.of-1PL
vagr-or	in.front.of-2SG
vagr-oraa	in.front.of-2PL
vagr-oraan	in.front.of-2PL
vagr-os	in.front.of-3SG
vagr-osaa	in.front.of-3PL
vagr-osaan	in.front.of-3PL
vak-	wear
vakkar-	dress
valaat	country
vaniišt	gum
varii	bride
varis	year
vars	year
varsaakivaa	a.year.ago
varsonà	years.old
varson	years.old
vaš-	burn
vašnaa-	burn
vašt-	hit.PROG
vat-	on
vat-i	on-3SG
vat-ii	on-3SG
vat-om	on-1SG
vat-omaa	on-1PL
vat-omaan	on-1PL
vat-or	on-2SG
vat-oraa	on-2PL
vat-oraan	on-2PL
vat-yaa	on-3PL
vat-yaan	on-3PL
vatii	on.it
vay-	open/hit
vayee-	hit
vayy-	open/hit
vayyaav-	be.hitted
vee	without
vee-	sit/live
veekeez	bad
veeš-	from
vees-	sit/live
veeš-om	from-1SG
veeš-or	from-2SG
veeš-omaa	from-1PL
veeš-omaan	from-1PL
veeš-oman	from-1PL
veeš-oraa	from-2PL
veeš-oraan	from-2PL
veeš-ii	from-3SG
veeš-yaa	from-3PL
viiš-yaa	from-3PL
veesnii	the.other.wife
veesiny	the.other.wife
vidd-	become.old.PFV
viddo-	become.old
vidii	old.woman
vidy	old.woman
viin-	pick
viis	twenty
viisḥašt	twenty.eight
viisḥawt	twenty.seven
viisnah	twenty.nine
viispanj	twentyfive
viiššeeš	twenty.six
viist	twenty
viisyeekaa	twenty.one
vindaas	slipper/shoe
vindaayà	song
vindaay	song
vindaayikar	sing
vindir-	stand
vindr-	stand
vjaal-	send
vodka	vodka
vodkaa	vodka
vyaar	town/market
wa	and
waaḥid	one
waajb	duty
waajib	duty
waan-	hold
waaxiz	blame
waaxiz-	blame
waaʕii	aware
waḍiʕ	condition
waḍʕ	condition
waffir-	save
wakiileek	swear
wakkil-	trust
wala	nor
walat	country
walla	or
wallah	by.God
waqit	time
waqqiʕ-	expect
waqt	time
waqtii	when
war	on.you
warriṭ-	be.in.trouble
warsiin	rain
warsiind	rain
warsiindà	rain
warṣiindà	rain
warsiindee	rain
warsindà	rain
warsind	rain
warsindee	rain
waṭ	stone
waṭakurii	stone.home
waxir	time
waxt	time
waxt-	time
waxtii	when
waʕʕii-	aware
willii	which
wilwilii-	scream
win-	copulate
wo	time
wor	time
wu	and
w-	and-
xaal	maternal.uncle
xaan-	cover
xaan	cover
xaanim	lady
xaarjà	lavatory
xaaṣ	special
xabar	news
xalaas-	finish
xalaṣ	enough
xalii	quick
xallif-	give.birth
xaly	quick
xalya	quickly
xalyaa	quickly
xam-	defecate
xamy-	defecate
xamiir	dough
xamiisà	Thursday
xamrii	wine
xannà	henna
xaraab	ruin
xaraab-	destroy
xarik	bone
xarjiiyà	expense
xark	bone
xarmaan	harvest
xaṣib	despite
xašiim	murky
xaššim-	hulimilate
xašt	hand
xatrà	time
xatr	time
xaṭṭaabà	engagement
xaṭxaṭ	striped
xay-	defecate
xayyir	generous
xayyir-	generous
xaz-	laugh
ġaz-	laugh
xazi-	laugh
xdim-	serve
xeemik	tent
xeemk	tent
xeem	tent
xeer	only/good
xfii-	hide
xidiʕ-	deceive
xiḍrà	vegetable
xii-	cook
xiif	snow/ice
xiinaa-	cook
xij	yesterday
xijontii	yesterday
xijotii	yesterday
xijotiinii	yesterday
xilaal	through
xilq-	tolerance
xir	heart/for
xir-	be.angry
xirii-	cooked
xirimà	inside
xirkeerà	for
xirkeeree	for
xirmà	dates
xisir-	lose
xiṣir-	lose
xiṭib-	engage
xitim-	stamp
xlaa-	settle
xulaa-	settle
xolaamiš-	get.annoyed
xolamiiš-	get.annoyed
xolamiš-	get.annoyed
xoraan	hip
xox	plum
xr	for
xrim	inside
xṣir-	lose
xtim-	stamp
xuḍrà	vegetable
xuḍree	vegetable
xuj	yesterday
xuja	yesterday
xujontii	yesterday
xujotii	yesterday
xujotiinii	yesterday
xul-	settle
xur	heart
xur-	be.angry/inside
xuraafaat	superstition
xurii-	be.coocked
xurkeeree	for
xurmà	dates
xurr-	be.angry/shout
xuu-	cook
xuuii-	cook
xuunaa-	cook
xuwa	god
xwaa	sky/God
xwaay	weather
yaa	and/VOC
yaakaani	alone
yaaṣii	afternoon
yaaṣy	afternoon
yaazaʕmannii	part
yahuudii	Jew
yalḍiẓ	star
yallii	REL
yamiin	right
yanaayir	January
yanaayr	January
yanayir	January
yaʕnii	it.means
yaʕni	it.means
yaʕnuu	that.is
yaʕṭiikii	thanks
yee	one
yee-	one
yeek	both/together
yeek-	both/together
yeeka	one
yeekaa	one
yeekak	one
yeekaak	one
yeekaak-	one
yeekeemaan	one.another
yeekeemaa	one.another
yeekeeman	one.another
yeekin	each.other
yeelkaanii	alone
yeeq-	swear
yeeq	swear
yeerkaanii	alone
yillii	REL
yilli	REL
yimkeen	maybe
yimkin	maybe
yirḥama	mercy.F
yirḥamo	mercy.M
yiʕaafiik	you’re.welcome
-yoka	one
yoka	one
yuka	one
yokaa	one
yunyuuvaayee	since.June
yuunyo	June
z-	from
z'aib	wolf
zà	from
za	from
ẓabbiṭ-	fix
zakkir-	remember
zakkirkaraa-	remind
zalamee	man
ẓamaan	past
zaman	time
ẓammir-	honk
zangiil	rich
zangiil-	rich
zanx	rust
zard	yellow
ẓavir	mouth
ẓawir	mouth
ẓawr	mouth
ẓawr	mouth
zee	of.this
zeedà	more
zeet	oil
zeeta	from.here
zeetaa	from.here
zeeva	from.here
zif-	accompany
ziirvaa-	forget
ziita	from.here
ziivraa-	forget
zivraa-	forget
ziivraay-	forget
zilġiiṭ	howl
zimmeeš	long.time.ago
zinx	stink
ẓir	spill
ẓir-	spill
ẓir-	spill
zirġiiṭ	howl
ziriʕ-	plant
ziʕij-	be.annoyed
zo	of.that
zobaʕà	sand.storm
ẓor	exceed/bad
ẓor-	exceed/bad
ẓortar	worse
zotaa	from.there
zriinj	bullet
zuur-	visit
zuwwa	from.there
zwir-	stare
zʕil-	be.sad
ziʕil-	be.sad
ʕaadaat	traditions
ʕaadat	traditions
ʕaadà	tradition
ʕaadee	tradition
ʕaad	tradition
ʕaadatan	normally
ʕaadii	normal
ʕaalij-	heal
ʕaam	general
ʕaamir	high
ʕaamuud	column
ʕaaqib-	punish
ʕaar	disgrace
ʕaard	ground/earth
ʕaarin	shame
ʕaaṣmà	capital
ʕaayil	issue
ʕaddii-	cross
ʕaddiiy-	cross
ʕaggib-	decorate
ʕajjib-	amaze
ʕakkaazà	crutch
ʕalee	on.M
ʕala	on
ʕalaa	on
ʕaleek	2SG.BEN
ʕallil-	be.awake
ʕalq-	hang
ʕamaarà	building
ʕammid-	baptise
ʕammir-	build
ʕammar-	build
ʕan	about
ʕaqil	mind
ʕaql	mind
ʕaqqor	walnut
ʕaraaq	Iraq
ʕarabaay	cart
ʕarabaayà	cart
ʕarabaayee	cart
ʕarabii	Arab/sofa
ʕarabiiy	cart
ʕarabiiyà	cart
ʕarbiṭ-	hang
ʕarḍ	honor
ʕarmuuṭ	pear
ʕarrif-	introduce
ʕašaa'eer	clans
ʕašaa’eer	clans
ʕasaas	actually
ʕasal	honey
ʕašiirà	clan
ʕašiiree	clan
ʕašiir	clan
ʕašiirat	clans
ʕaskar	soldier
ʕaskariiyee	army
ʕaskaryee	army
ʕaskariiy	army
ʕaskarii	army
ʕaskary	army
ʕašra	ten
ʕaṣṣib	get.angry
ʕaṣṣib-	get.angry
ʕawwid-	get.used
ʕawwiz-	seek.refuge
ʕayb	shame
ʕaza	funeral
ʕazaa	funeral
ʕazaab	torment
ʕazab	unmarried.boy
ʕazif	play.on.an.instrument
ʕaziimà	invitation
ʕaziimat	invite
ʕazzib-	torture/tired
ʕdaab-	tired
ʕeelat	family
ʕeelee	family
ʕeesar	tears
ʕid-	count
ʕidil	sack
ʕidim-	execute
ʕidkar-	count
ʕiiš-	live
ʕijb-	like
ʕijib-	like
ʕilbik	bottle
ʕimaarà	building
ʕimaar	building
ʕimir	age
ʕimr	age
ʕumr	age
ʕinṣiriiyà	racism
ʕirq	race
ʕirqii	ethnic
ʕirqi	ethnic
ʕizif-	play
ʕizraayiin	Azrael
ʕraaq	Iraq
ʕyaadà	clinic
ʕzif-	play
kar	pot
kun-	exit
šukul	form
masbaḥa	rosary
ziʕil-	sad
tukn	Turkey
flaan	someone
čloy	shell
annehaan	like.this
xlaa	camp
quš-	sweep
kiilà	red.stone
xanna	henna
xannee	henna
maʕd	stomach
xul-	camp
qziikar-	call
il’aan	now
kawwin-	establish
vaar	bride
šir-	stand
jaal-	send
sik-	learn
ṭfii-	extinguish
away	yes
iḥririm-	respect
siidii	my lord
paar-	take
paar	take
ṭama	PART
xeer	except
war	PART
li'anni	because
xaṭṭaab	engagement
hanee	those
paš	five
tane	piece
laka	sure
tirb	grave
tirbee	grave
willa	or
lim-	keep
jyeesaat	souls
likar-	stick
drog-	big
sijn	prison
dayna	stick
rayyiḥ-	comfortable
qult-	ride
ištaał-	carry
mar	dead
slaaḥ	gun
xašiimiš	darkness
čraak	light
kita	where
kità	where/how
mukro	bus
taabiʕ-	follow
fa	and.so
ḥimraa	lipstick
nafsiiya	mindset
rayyiḥ-	calm
-ond	-3PL
-ond-aa	-3PL-REM
-ond-ee	-3PL-PRES
-ond-is	-3PL-3SG
-ond-imaan-aa	-3PL-1PL-REM
-itiš-aa	-COP/PROG-REM
-itiš-ee	-COP/PROG-PRES
-itiš-im-ir-aa	-PROG-1SG-2SG-REM
-itiš-im-ir-ee	-PROG-1SG-2SG-PRES
-itiš-im-iraan-aa	-PROG-1SG-2PL-REM
-itiš-im-iraan-ee	-PROG-1SG-2PL-PRES
-itiš-im-is-aa	-PROG-1SG-3SG-REM
-itiš-im-is-ee	-PROG-1SG-3SG-PRES
-itiš-im-isaan-aa	-PROG-1SG-3PL-REM
-itiš-im-isaan-ee	-PROG-1SG-3PL-PRES
-itiš-im-r-aa	-PROG-1SG-2SG-REM
-itiš-im-r-ee	-PROG-1SG-2SG-PRES
-itiš-im-raan-aa	-PROG-1SG-2PL-REM
-itiš-im-raan-ee	-PROG-1SG-2PL-PRES
-itiš-im-s-aa	-PROG-1SG-3SG-REM
-itiš-im-s-ee	-PROG-1SG-3SG-PRES
-itiš-im-saan-aa	-PROG-1SG-3PL-REM
-itiš-im-saan-ee	-PROG-1SG-3PL-PRES
-itiš-ind	-COP/PROG-3PL
-itiš-ind-aa	-COP/PROG-3PL-REM
-itiš-ind-ee	-COP/PROG-3PL-PRES
-itiš-ind-im-aa	-PROG-3PL-1SG-REM
-itiš-ind-im-ee	-PROG-3PL-1SG-PRES
-itiš-ind-imaan-aa	-PROG-3PL-1PL-REM
-itiš-ind-imaan-ee	-PROG-3PL-1PL-PRES
-itiš-ind-ir-aa	-PROG-3PL-2SG-REM
-itiš-ind-ir-ee	-PROG-3PL-2SG-PRES
-itiš-ind-iraan-aa	-PROG-3PL-2PL-REM
-itiš-ind-iraan-ee	-PROG-3PL-2PL-PRES
-itiš-ind-is-aa	-PROG-3PL-3SG-REM
-itiš-ind-is-ee	-PROG-3PL-3SG-PRES
-itiš-ind-isaan-aa	-PROG-3PL-3PL-REM
-itiš-ind-isaan-ee	-PROG-3PL-3PL-PRES
-itiš-inn	-COP/PROG-1PL
-itiš-inn-aa	-COP/PROG-1PL-REM
-itiš-inn-ee	-COP/PROG-1PL-PRES
-itiš-ir-im-aa	-PROG-3SG-1SG-REM
-itiš-ir-im-ee	-PROG-3SG-1SG-PRES
-itiš-ir-imaan-aa	-PROG-3SG-1PL-REM
-itiš-ir-imaan-ee	-PROG-3SG-1PL-PRES
-itiš-ir-ir-aa	-PROG-3SG-2SG-REM
-itiš-ir-ir-ee	-PROG-3SG-2SG-PRES
-itiš-ir-iraan-aa	-PROG-3SG-2PL-REM
-itiš-ir-iraan-ee	-PROG-3SG-2PL-PRES
-itiš-ir-is-aa	-PROG-3SG-3SG-REM
-itiš-ir-is-ee	-PROG-3SG-3SG-PRES
-itiš-ir-isaan-aa	-PROG-3SG-3PL-REM
-itiš-ir-isaan-ee	-PROG-3SG-3PL-PRES
-itiš-ir-m-aa	-PROG-3SG-1SG-REM
-itiš-ir-m-ee	-PROG-3SG-1SG-PRES
-itiš-ir-maan-aa	-PROG-3SG-1PL-REM
-itiš-ir-maan-ee	-PROG-3SG-1PL-PRES
-itiš-ir-r-aa	-PROG-3SG-2SG-REM
-itiš-ir-r-ee	-PROG-3SG-2SG-PRES
-itiš-ir-raan-aa	-PROG-3SG-2PL-REM
-itiš-ir-raan-ee	-PROG-3SG-2PL-PRES
-itiš-ir-s-aa	-PROG-3SG-3SG-REM
-itiš-ir-s-ee	-PROG-3SG-3SG-PRES
-itiš-ir-saan-aa	-PROG-3SG-3PL-REM
-itiš-ir-saan-ee	-PROG-3SG-3PL-PRES
-itiš-is-m	-PROG-3SG-1SG
-itiš-is-m-aa	-PROG-3SG-1SG-REM
-itiš-is-m-ee	-PROG-3SG-1SG-PRES
-itiš-is-maan	-PROG-3SG-1PL
-itiš-is-maan-aa	-PROG-3SG-1PL-REM
-itiš-is-maan-ee	-PROG-3SG-1PL-PRES
-itiš-is-r	-PROG-3SG-2SG
-itiš-is-r-aa	-PROG-3SG-2SG-REM
-itiš-is-r-ee	-PROG-3SG-2SG-PRES
-itiš-is-raan	-PROG-3SG-2PL
-itiš-is-raan-aa	-PROG-3SG-2PL-REM
-itiš-is-raan-ee	-PROG-3SG-2PL-PRES
-itiš-is-s	-PROG-3SG-3SG
-itiš-is-s-aa	-PROG-3SG-3SG-REM
-itiš-is-s-ee	-PROG-3SG-3SG-PRES
-itiš-is-saan	-PROG-3SG-3PL
-itiš-is-saan-aa	-PROG-3SG-3PL-REM
-itiš-is-saan-ee	-PROG-3SG-3PL-PRES
-itiš-iss	-COP/PROG-2PL
-itiš-iss-aa	-COP/PROG-2PL-REM
-itiš-iss-ee	-COP/PROG-2PL-PRES
-itiš-m-ir-aa	-PROG-1SG-2SG-REM
-itiš-m-ir-ee	-PROG-1SG-2SG-PRES
-itiš-m-iraan-aa	-PROG-1SG-2PL-REM
-itiš-m-iraan-ee	-PROG-1SG-2PL-PRES
-itiš-m-is-aa	-PROG-1SG-3SG-REM
-itiš-m-is-ee	-PROG-1SG-3SG-PRES
-itiš-m-isaan-aa	-PROG-1SG-3PL-REM
-itiš-m-isaan-ee	-PROG-1SG-3PL-PRES
-itiš-om	-COP/PROG-1SG
-itiš-om-aa	-COP/PROG-1SG-REM
-itiš-om-ee	-COP/PROG-1SG-PRES
-itiš-om-ir-aa	-PROG-1SG-2SG-REM
-itiš-om-ir-ee	-PROG-1SG-2SG-PRES
-itiš-om-iraan-aa	-PROG-1SG-2PL-REM
-itiš-om-iraan-ee	-PROG-1SG-2PL-PRES
-itiš-om-is-aa	-PROG-1SG-3SG-REM
-itiš-om-is-ee	-PROG-1SG-3SG-PRES
-itiš-om-isaan-aa	-PROG-1SG-3PL-REM
-itiš-om-isaan-ee	-PROG-1SG-3PL-PRES
-itiš-or	-COP/PROG-2SG
-itiš-or-aa	-COP/PROG-2SG-REM
-itiš-or-ee	-COP/PROG-2SG-PRES
-itiš-or-im	-PROG-2SG-1SG
-itiš-or-im-aa	-PROG-2SG-1SG-REM
-itiš-or-im-ee	-PROG-2SG-1SG-PRES
-itiš-or-imaa	-PROG-2SG-1PL
-itiš-or-imaan	-PROG-2SG-1PL
-itiš-or-imaan-aa	-PROG-2SG-1PL-REM
-itiš-or-imaan-ee	-PROG-2SG-1PL-PRES
-itiš-or-is	-PROG-2SG-3SG
-itiš-or-is-aa	-PROG-2SG-3SG-REM
-itiš-or-is-ee	-PROG-2SG-3SG-PRES
-itiš-or-isaa	-PROG-2SG-3PL
-itiš-or-isaan	-PROG-2SG-3PL
-itiš-or-isaan-aa	-PROG-2SG-3PL-REM
-itiš-or-isaan-ee	-PROG-2SG-3PL-PRES
-itiš-or-m-aa	-PROG-2SG-1SG-REM
-itiš-or-m-ee	-PROG-2SG-1SG-PRES
-itiš-or-maan-aa	-PROG-2SG-1PL-REM
-itiš-or-maan-ee	-PROG-2SG-1PL-PRES
-itiš-or-s-aa	-PROG-2SG-3SG-REM
-itiš-or-s-ee	-PROG-2SG-3SG-PRES
-itiš-or-saan-aa	-PROG-2SG-3PL-REM
-itiš-or-saan-ee	-PROG-2SG-3PL-PRES
-itiš-r-im-aa	-PROG-3SG-1SG-REM
-itiš-r-im-ee	-PROG-3SG-1SG-PRES
-itiš-r-imaan-aa	-PROG-3SG-1PL-REM
-itiš-r-imaan-ee	-PROG-3SG-1PL-PRES
-itiš-r-ir-aa	-PROG-3SG-2SG-REM
-itiš-r-ir-ee	-PROG-3SG-2SG-PRES
-itiš-r-iraan-aa	-PROG-3SG-2PL-REM
-itiš-r-iraan-ee	-PROG-3SG-2PL-PRES
-itiš-r-is-aa	-PROG-3SG-3SG-REM
-itiš-r-is-ee	-PROG-3SG-3SG-PRES
-itiš-r-isaan-aa	-PROG-3SG-3PL-REM
-itiš-r-isaan-ee	-PROG-3SG-3PL-PRES
-iš-n-aa	-COP/PROG-1PL-REM
-iš-n-ee	-COP/PROG-1PL-PRES
-iš-n-e	-COP/PROG-1PL-PRES
-iš-aa	-COP/PROG-REM
-iš-ee	-COP/PROG-PRES
-iš-im-ir-aa	-PROG-1SG-2SG-REM
-iš-im-ir-ee	-PROG-1SG-2SG-PRES
-iš-im-iraan-aa	-PROG-1SG-2PL-REM
-iš-im-iraan-ee	-PROG-1SG-2PL-PRES
-iš-im-is-aa	-PROG-1SG-3SG-REM
-iš-im-is-ee	-PROG-1SG-3SG-PRES
-iš-im-isaan-aa	-PROG-1SG-3PL-REM
-iš-im-isaan-ee	-PROG-1SG-3PL-PRES
-iš-im-r-aa	-PROG-1SG-2SG-REM
-iš-im-r-ee	-PROG-1SG-2SG-PRES
-iš-im-raan-aa	-PROG-1SG-2PL-REM
-iš-im-raan-ee	-PROG-1SG-2PL-PRES
-iš-im-s-aa	-PROG-1SG-3SG-REM
-iš-im-s-ee	-PROG-1SG-3SG-PRES
-iš-im-saan-aa	-PROG-1SG-3PL-REM
-iš-im-saan-ee	-PROG-1SG-3PL-PRES
-iš-ind	-COP/PROG-3PL
-iš-ind-aa	-COP/PROG-3PL-REM
-iš-ind-ee	-COP/PROG-3PL-PRES
-iš-ind-im-aa	-PROG-3PL-1SG-REM
-iš-ind-im-ee	-PROG-3PL-1SG-PRES
-iš-ind-imaan-aa	-PROG-3PL-1PL-REM
-iš-ind-imaan-ee	-PROG-3PL-1PL-PRES
-iš-ind-ir-aa	-PROG-3PL-2SG-REM
-iš-ind-ir-ee	-PROG-3PL-2SG-PRES
-iš-ind-iraan-aa	-PROG-3PL-2PL-REM
-iš-ind-iraan-ee	-PROG-3PL-2PL-PRES
-iš-ind-is-aa	-PROG-3PL-3SG-REM
-iš-ind-is-ee	-PROG-3PL-3SG-PRES
-iš-ind-isaan-aa	-PROG-3PL-3PL-REM
-iš-ind-isaan-ee	-PROG-3PL-3PL-PRES
-iš-inn	-COP/PROG-1PL
-iš-inn-aa	-COP/PROG-1PL-REM
-iš-inn-ee	-COP/PROG-1PL-PRES
-š-inn-e	-COP/PROG-1PL-PRES
-iš-ir-im-aa	-PROG-3SG-1SG-REM
-iš-ir-im-ee	-PROG-3SG-1SG-PRES
-iš-ir-imaan-aa	-PROG-3SG-1PL-REM
-iš-ir-imaan-ee	-PROG-3SG-1PL-PRES
-iš-ir-ir-aa	-PROG-3SG-2SG-REM
-iš-ir-ir-ee	-PROG-3SG-2SG-PRES
-iš-ir-iraan-aa	-PROG-3SG-2PL-REM
-iš-ir-iraan-ee	-PROG-3SG-2PL-PRES
-iš-ir-is-aa	-PROG-3SG-3SG-REM
-iš-ir-is-ee	-PROG-3SG-3SG-PRES
-iš-ir-isaan-aa	-PROG-3SG-3PL-REM
-iš-ir-isaan-ee	-PROG-3SG-3PL-PRES
-iš-ir-m-aa	-PROG-3SG-1SG-REM
-iš-ir-m-ee	-PROG-3SG-1SG-PRES
-iš-ir-maan-aa	-PROG-3SG-1PL-REM
-iš-ir-maan-ee	-PROG-3SG-1PL-PRES
-iš-ir-r-aa	-PROG-3SG-2SG-REM
-iš-ir-r-ee	-PROG-3SG-2SG-PRES
-iš-ir-raan-aa	-PROG-3SG-2PL-REM
-iš-ir-raan-ee	-PROG-3SG-2PL-PRES
-iš-ir-s-aa	-PROG-3SG-3SG-REM
-iš-ir-s-ee	-PROG-3SG-3SG-PRES
-iš-ir-saan-aa	-PROG-3SG-3PL-REM
-iš-ir-saan-ee	-PROG-3SG-3PL-PRES
-iš-is-m	-PROG-3SG-1SG
-iš-is-m-aa	-PROG-3SG-1SG-REM
-iš-is-m-ee	-PROG-3SG-1SG-PRES
-iš-is-maan	-PROG-3SG-1PL
-iš-is-maan-aa	-PROG-3SG-1PL-REM
-iš-is-maan-ee	-PROG-3SG-1PL-PRES
-iš-is-r	-PROG-3SG-2SG
-iš-is-r-aa	-PROG-3SG-2SG-REM
-iš-is-r-ee	-PROG-3SG-2SG-PRES
-iš-is-raan	-PROG-3SG-2PL
-iš-is-raan-aa	-PROG-3SG-2PL-REM
-iš-is-raan-ee	-PROG-3SG-2PL-PRES
-iš-is-s	-PROG-3SG-3SG
-iš-is-s-aa	-PROG-3SG-3SG-REM
-iš-is-s-ee	-PROG-3SG-3SG-PRES
-iš-is-saan	-PROG-3SG-3PL
-iš-is-saan-aa	-PROG-3SG-3PL-REM
-iš-is-saan-ee	-PROG-3SG-3PL-PRES
-iš-iss	-COP/PROG-2PL
-iš-iss-aa	-COP/PROG-2PL-REM
-iš-iss-ee	-COP/PROG-2PL-PRES
-iš-m-ir-aa	-PROG-1SG-2SG-REM
-iš-m-ir-ee	-PROG-1SG-2SG-PRES
-iš-m-iraan-aa	-PROG-1SG-2PL-REM
-iš-m-iraan-ee	-PROG-1SG-2PL-PRES
-iš-m-is-aa	-PROG-1SG-3SG-REM
-iš-m-is-ee	-PROG-1SG-3SG-PRES
-iš-m-isaan-aa	-PROG-1SG-3PL-REM
-iš-m-isaan-ee	-PROG-1SG-3PL-PRES
-iš-om	-COP/PROG-1SG
-iš-om-aa	-COP/PROG-1SG-REM
-iš-om-ee	-COP/PROG-1SG-PRES
-iš-om-ir-aa	-PROG-1SG-2SG-REM
-iš-om-ir-ee	-PROG-1SG-2SG-PRES
-iš-om-iraan-aa	-PROG-1SG-2PL-REM
-iš-om-iraan-ee	-PROG-1SG-2PL-PRES
-iš-om-is-aa	-PROG-1SG-3SG-REM
-iš-om-is-ee	-PROG-1SG-3SG-PRES
-iš-om-isaan-aa	-PROG-1SG-3PL-REM
-iš-om-isaan-ee	-PROG-1SG-3PL-PRES
-iš-or	-COP/PROG-2SG
-iš-or-aa	-COP/PROG-2SG-REM
-iš-or-ee	-COP/PROG-2SG-PRES
-iš-or-im	-PROG-2SG-1SG
-iš-or-im-aa	-PROG-2SG-1SG-REM
-iš-or-im-ee	-PROG-2SG-1SG-PRES
-iš-or-imaa	-PROG-2SG-1PL
-iš-or-imaan	-PROG-2SG-1PL
-iš-or-imaan-aa	-PROG-2SG-1PL-REM
-iš-or-imaan-ee	-PROG-2SG-1PL-PRES
-iš-or-is	-PROG-2SG-3SG
-iš-or-is-aa	-PROG-2SG-3SG-REM
-iš-or-is-ee	-PROG-2SG-3SG-PRES
-iš-or-isaa	-PROG-2SG-3PL
-iš-or-isaan	-PROG-2SG-3PL
-iš-or-isaan-aa	-PROG-2SG-3PL-REM
-iš-or-isaan-ee	-PROG-2SG-3PL-PRES
-iš-or-m-aa	-PROG-2SG-1SG-REM
-iš-or-m-ee	-PROG-2SG-1SG-PRES
-iš-or-maan-aa	-PROG-2SG-1PL-REM
-iš-or-maan-ee	-PROG-2SG-1PL-PRES
-iš-or-s-aa	-PROG-2SG-3SG-REM
-iš-or-s-ee	-PROG-2SG-3SG-PRES
-iš-or-saan-aa	-PROG-2SG-3PL-REM
-iš-or-saan-ee	-PROG-2SG-3PL-PRES
-iš-r-im-aa	-PROG-3SG-1SG-REM
-iš-r-im-ee	-PROG-3SG-1SG-PRES
-iš-r-imaan-aa	-PROG-3SG-1PL-REM
-iš-r-imaan-ee	-PROG-3SG-1PL-PRES
-iš-r-ir-aa	-PROG-3SG-2SG-REM
-iš-r-ir-ee	-PROG-3SG-2SG-PRES
-iš-r-iraan-aa	-PROG-3SG-2PL-REM
-iš-r-iraan-ee	-PROG-3SG-2PL-PRES
-iš-r-is-aa	-PROG-3SG-3SG-REM
-iš-r-is-ee	-PROG-3SG-3SG-PRES
-iš-r-isaan-aa	-PROG-3SG-3PL-REM
-iš-r-isaan-ee	-PROG-3SG-3PL-PRES
-očč-ind-im	-SUBJ-3PL-1SG
-očč-ind-ir	-SUBJ-3PL-2SG
-aa-m-ir-ee	-CAUS-1SG-2SG-PRES
-kar-d-een-ee	-VTR-PFV-1PL-PRES
aywa	yes
-o-saan-ee	-2SG-3PL-PRES
-o-saan-aa	-2SG-3PL-REM
-yaav-č-ir	-VITR-SUBJ-3SG
-yaav-č-ir-ee	-VITR-SUBJ-3SG-PRES
-yaav-č-ir-aa	-VITR-SUBJ-3SG-REM
-yaav-išt-ee	-VITR-PROG-PRES
-aa-d-à	-CAUS-PFV-3SG
-aa-d-eend	-CAUS-PFV-3PL
-aa-d-een-is	-CAUS-PFV-3PL-3SG
-aa-d-eend-is	-CAUS-PFV-3PL-3SG
-aa-d-eed-isaa		-CAUS-PFV-3PL-3PL
-aa-d-eend-isaa		-CAUS-PFV-3PL-3PL
-aa-rd-à	-CAUS-PFV-3SG
-aa-rd-eend-imaan	-CAUS-PFV-3PL-1PL
-naaw-osaan-ee	-CAUS-3PL-PRES
-iin-ee	-PL-PRES
-in-saa	-OBL.PL-SOC
miš	NEG
pač-os	behind-3SG
pač-or	behind-2SG
pač-om	behind-1SG
pač-osaa	behind-3PL
pač-oraa	behind-2PL
pač-omaa	behind-1PL
pač-osaan	behind-3PL
pač-oraan	behind-2PL
pač-omaan	behind-1PL
bašar	skin
-št-ir	-PROG-3SG
-yim	-LOC
ayyaam	days
iiyaam	days
yom	day
-aak-ee	-INDEF-PRES
li-	to-
-ind-r-ee	-3PL-2SG-PRES
-kay-ind-r-ee	-VTR-3PL-2SG-PRES
-os-ee	-3SG-PRES
-kar-os-ee	-VTR-3SG-PRES
-kr-or-imaa	-VTR-2SG-1PL
-kr-or-imaan	-VTR-2SG-1PL
-kr-or-im	-VTR-2SG-1SG
-kr-or-is	-VTR-2SG-3SG
-kr-or-isaa	-VTR-2SG-3PL
-kr-or-isaan	-VTR-2SG-3PL
-kr-d-een	-VTR-PFV-1PL
-k-r-eend-ir	-VTR-PFV-3PL-3SG
-s-isaan-aa	-2PL-3PL-REM
-s-saan-aa	-2PL-3PL-REM
-omaan-aa	-1PL-REM
-omaan-ee	-1PL-PRES
-om-ee	-1SG-PRES
-ees-im	-OBL.SG-LOC
-om-s-ee	-1SG-3SG-PRES
zaʕfaraan	saffron
sarbiis	service
-eend-ir	-3PL-2SG
afriiqya	Africa
-aa-m-isaa	-CAUS-1SG-1PL
-aa-nd-imaan-ee	-CAUS-3PL-1PL-PRES