want-COP/PROG	want-PROG
say/good-COP/PROG	say-PROG
go-COP/PROG	go-PROG
know/spray-COP/PROG	know/spray-PROG
do/make-COP/PROG	do/make-PROG
come-COP/PROG	come-PROG
see-COP/PROG	see-PROG
look.after-COP/PROG	look.after-PROG
give-COP/PROG	give-PROG
give.birth-COP/PROG	give.birth-PROG
put/give-COP/PROG	put/give-PROG
take-COP/PROG	take-PROG
say-COP/PROG	say-PROG
bring-COP/PROG	bring-PROG
bring.back-COP/PROG	bring.back-PROG
eat-COP/PROG	eat-PROG
eat/vomit-COP/PROG	eat/vomit-PROG
drink-COP/PROG	drink-PROG
return-COP/PROG	return-PROG
hear/knead-COP/PROG	hear/knead-PROG
hear-COP/PROG	hear-PROG
sit/live-COP/PROG	sit/live-PROG
sleep-COP/PROG	sleep-PROG
stand-COP/PROG	stand-PROG
stay/wait/stand.up-COP/PROG	stay/wait/stand.up-PROG
stand.up-COP/PROG	stand.up-PROG
run-COP/PROG	run-PROG
run.away-COP/PROG	run.away-PROG
fall-COP/PROG	fall-PROG
die-COP/PROG	die-PROG
exit-COP/PROG	exit-PROG
enter-COP/PROG	enter-PROG
open/hit-COP/PROG	open/hit-PROG
hit-COP/PROG	hit-PROG
grab/hold-COP/PROG	grab/hold-PROG
hold-COP/PROG	hold-PROG
work-COP/PROG	work-PROG
shut-COP/PROG	shut-PROG
forget-COP/PROG	forget-PROG
sell-COP/PROG	sell-PROG
buy/scare-COP/PROG	buy/scare-PROG
wash-COP/PROG	wash-PROG
spread-COP/PROG	spread-PROG
learn-COP/PROG	learn-PROG
play-COP/PROG	play-PROG
jump-COP/PROG	jump-PROG
cry-COP/PROG	cry-PROG
laugh-COP/PROG	laugh-PROG
burn-COP/PROG	burn-PROG
call-COP/PROG	call-PROG
call/knock-COP/PROG	call/knock-PROG
send-COP/PROG	send-PROG
pull-COP/PROG	pull-PROG
push-COP/PROG	push-PROG
break-COP/PROG	break-PROG
say/good-VTR	say-VTR
people-3SG/2PL/OBL.SG/2PL.IMP	people-OBL.SG
country-3SG/2PL/OBL.SG/2PL.IMP	country-OBL.SG
smooth-GEN/M/OBL.SG	smooth-M
throw/who-VITR/INDEF/3PL/REM/and	who-REM
girl-VITR/INDEF/3PL/REM/and	girl-REM/INDEF
whose-FUT/-with/-DIR	whose-DIR
something-REM/2SG.PRES/2SG/INDEF/CAUS	something-REM/INDEF
piece-REM/2SG.PRES/2SG/INDEF/CAUS	piece-REM/INDEF
house-1SG/1SG/LOC	house-LOC
blanket-REM/2SG.PRES/2SG/INDEF/CAUS	blanket-REM/INDEF
wool-GEN/M/OBL.SG	wool-GEN/OBL.SG 
mattress-REM/2SG.PRES/2SG/INDEF/CAUS	mattress-REM/INDEF
say/good-PFV	say-PFV
word-3SG/2PL/OBL.SG/2PL.IMP	word-3SG/OBL.SG
where/it.was/which-SG-3PL-DIR	which-SG-3PL-DIR
whose-FUT/-with/-DIR	whose-DIR
grandfather-SG-2SG/-VITR-3SG	grandfather-SG-2SG
take/NEG-come	NEG-come
take/NEG-want	NEG-want
take/NEG-say/good	NEG-say
take/NEG-go	NEG-go
take/NEG-know/spray	NEG-know/spray
take/NEG-do/make	NEG-do/make
take/NEG-come	NEG-come
take/NEG-see	NEG-see
take/NEG-look.after	NEG-look.after
take/NEG-give	NEG-give
take/NEG-give.birth	NEG-give.birth
take/NEG-put/give	NEG-put/give
take/NEG-take	NEG-take
take/NEG-say	NEG-say
take/NEG-bring	NEG-bring
take/NEG-bring.back	NEG-bring.back
take/NEG-eat	NEG-eat
take/NEG-eat/vomit	NEG-eat/vomit
take/NEG-drink	NEG-drink
take/NEG-return	NEG-return
take/NEG-hear/knead	NEG-hear/knead
take/NEG-hear	NEG-hear
take/NEG-sit/live	NEG-sit/live
take/NEG-sleep	NEG-sleep
take/NEG-stand	NEG-stand
take/NEG-stay/wait/stand.up	NEG-stay/wait/stand.up
take/NEG-stand.up	NEG-stand.up
take/NEG-run	NEG-run
take/NEG-run.away	NEG-run.away
take/NEG-fall	NEG-fall
take/NEG-die	NEG-die
take/NEG-exit	NEG-exit
take/NEG-enter	NEG-enter
take/NEG-open/hit	NEG-open/hit
take/NEG-hit	NEG-hit
take/NEG-grab/hold	NEG-grab/hold
take/NEG-hold	NEG-hold
take/NEG-work	NEG-work
take/NEG-shut	NEG-shut
take/NEG-forget	NEG-forget
take/NEG-sell	NEG-sell
take/NEG-buy/scare	NEG-buy/scare
take/NEG-wash	NEG-wash
take/NEG-spread	NEG-spread
take/NEG-learn	NEG-learn
take/NEG-play	NEG-play
take/NEG-jump	NEG-jump
take/NEG-cry	NEG-cry
take/NEG-laugh	NEG-laugh
take/NEG-burn	NEG-burn
take/NEG-call	NEG-call
take/NEG-call/knock	NEG-call/knock
take/NEG-send	NEG-send
take/NEG-pull	NEG-pull
take/NEG-push	NEG-push
take/NEG-break	NEG-break
pound/paper-REM/2SG.PRES/2SG/INDEF/CAUS	pound/paper-REM/INDEF
on-2SG-PRES/2SG.PRES/PL	on-2SG-PRES
come-2SG/3SG	come-3SG
want-2SG/3SG	want-3SG
say/good-2SG/3SG	say-3SG
go-2SG/3SG	go-3SG
know/spray-2SG/3SG	know/spray-3SG
do/make-2SG/3SG	do/make-3SG
come-2SG/3SG	come-3SG
see-2SG/3SG	see-3SG
look.after-2SG/3SG	look.after-3SG
give-2SG/3SG	give-3SG
give.birth-2SG/3SG	give.birth-3SG
put/give-2SG/3SG	put/give-3SG
take-2SG/3SG	take-3SG
say-2SG/3SG	say-3SG
bring-2SG/3SG	bring-3SG
bring.back-2SG/3SG	bring.back-3SG
eat-2SG/3SG	eat-3SG
eat/vomit-2SG/3SG	eat/vomit-3SG
drink-2SG/3SG	drink-3SG
return-2SG/3SG	return-3SG
hear/knead-2SG/3SG	hear/knead-3SG
hear-2SG/3SG	hear-3SG
sit/live-2SG/3SG	sit/live-3SG
sleep-2SG/3SG	sleep-3SG
stand-2SG/3SG	stand-3SG
stay/wait/stand.up-2SG/3SG	stay/wait/stand.up-3SG
stand.up-2SG/3SG	stand.up-3SG
run-2SG/3SG	run-3SG
run.away-2SG/3SG	run.away-3SG
fall-2SG/3SG	fall-3SG
die-2SG/3SG	die-3SG
exit-2SG/3SG	exit-3SG
enter-2SG/3SG	enter-3SG
open/hit-2SG/3SG	open/hit-3SG
hit-2SG/3SG	hit-3SG
grab/hold-2SG/3SG	grab/hold-3SG
hold-2SG/3SG	hold-3SG
work-2SG/3SG	work-3SG
shut-2SG/3SG	shut-3SG
forget-2SG/3SG	forget-3SG
sell-2SG/3SG	sell-3SG
buy/scare-2SG/3SG	buy/scare-3SG
wash-2SG/3SG	wash-3SG
spread-2SG/3SG	spread-3SG
learn-2SG/3SG	learn-3SG
play-2SG/3SG	play-3SG
jump-2SG/3SG	jump-3SG
cry-2SG/3SG	cry-3SG
laugh-2SG/3SG	laugh-3SG
burn-2SG/3SG	burn-3SG
call-2SG/3SG	call-3SG
call/knock-2SG/3SG	call/knock-3SG
send-2SG/3SG	send-3SG
pull-2SG/3SG	pull-3SG
push-2SG/3SG	push-3SG
break-2SG/3SG	break-3SG
REFL-3PL-PRES/2SG.PRES/PL	REFL-3PL-PRES
Aleppo-1SG/LOC	 Aleppo-LOC
where/it.was/which-SG-2SG/-VITR-3SG-GEN/M/OBL.SG	which-SG-2SG-GEN
someone-PRES/2SG.PRES/PL	someone-PRES/PL
doctor-3SG/2PL/OBL.SG/2PL.IMP	doctor-3SG/OBL.SG
someone-3SG/2PL/OBL.SG/2PL.IMP	someone-3SG/OBL.SG
country-1PL/NEG/OBL.PL/DEF	country-OBL.PL/DEF
mucus-SG-2SG/-VITR-3SG	mucus-SG-2SG
know-VITR/INDEF/3PL/REM/and	know-VITR/3PL/REM
VTR-PFV-2SG-SOC/COND/3PL	VTR-PFV-2SG-COND/3PL
house-1SG/LOC	house-LOC
throw/who-PRES	who-PRES
bring.PFV-3SG/2PL/OBL.SG/2PL.IMP	bring.PFV-2PL/2PL.IMP
want-3SG/2PL/OBL.SG/2PL.IMP	want-2PL/2PL.IMP
say/good-3SG/2PL/OBL.SG/2PL.IMP	say-2PL/2PL.IMP
go-3SG/2PL/OBL.SG/2PL.IMP	go-2PL/2PL.IMP
know/spray-3SG/2PL/OBL.SG/2PL.IMP	know/spray-2PL/2PL.IMP
do/make-3SG/2PL/OBL.SG/2PL.IMP	do/make-2PL/2PL.IMP
come-3SG/2PL/OBL.SG/2PL.IMP	come-2PL/2PL.IMP
see-3SG/2PL/OBL.SG/2PL.IMP	see-2PL/2PL.IMP
look.after-3SG/2PL/OBL.SG/2PL.IMP	look.after-2PL/2PL.IMP
give-3SG/2PL/OBL.SG/2PL.IMP	give-2PL/2PL.IMP
give.birth-3SG/2PL/OBL.SG/2PL.IMP	give.birth-2PL/2PL.IMP
put/give-3SG/2PL/OBL.SG/2PL.IMP	put/give-2PL/2PL.IMP
take-3SG/2PL/OBL.SG/2PL.IMP	take-2PL/2PL.IMP
say-3SG/2PL/OBL.SG/2PL.IMP	say-2PL/2PL.IMP
bring-3SG/2PL/OBL.SG/2PL.IMP	bring-2PL/2PL.IMP
bring.back-3SG/2PL/OBL.SG/2PL.IMP	bring.back-2PL/2PL.IMP
eat-3SG/2PL/OBL.SG/2PL.IMP	eat-2PL/2PL.IMP
eat/vomit-3SG/2PL/OBL.SG/2PL.IMP	eat/vomit-2PL/2PL.IMP
drink-3SG/2PL/OBL.SG/2PL.IMP	drink-2PL/2PL.IMP
return-3SG/2PL/OBL.SG/2PL.IMP	return-2PL/2PL.IMP
hear/knead-3SG/2PL/OBL.SG/2PL.IMP	hear/knead-2PL/2PL.IMP
hear-3SG/2PL/OBL.SG/2PL.IMP	hear-2PL/2PL.IMP
sit/live-3SG/2PL/OBL.SG/2PL.IMP	sit/live-2PL/2PL.IMP
sleep-3SG/2PL/OBL.SG/2PL.IMP	sleep-2PL/2PL.IMP
stand-3SG/2PL/OBL.SG/2PL.IMP	stand-2PL/2PL.IMP
stay/wait/stand.up-3SG/2PL/OBL.SG/2PL.IMP	stay/wait/stand.up-2PL/2PL.IMP
stand.up-3SG/2PL/OBL.SG/2PL.IMP	stand.up-2PL/2PL.IMP
run-3SG/2PL/OBL.SG/2PL.IMP	run-2PL/2PL.IMP
run.away-3SG/2PL/OBL.SG/2PL.IMP	run.away-2PL/2PL.IMP
fall-3SG/2PL/OBL.SG/2PL.IMP	fall-2PL/2PL.IMP
die-3SG/2PL/OBL.SG/2PL.IMP	die-2PL/2PL.IMP
exit-3SG/2PL/OBL.SG/2PL.IMP	exit-2PL/2PL.IMP
enter-3SG/2PL/OBL.SG/2PL.IMP	enter-2PL/2PL.IMP
open/hit-3SG/2PL/OBL.SG/2PL.IMP	open/hit-2PL/2PL.IMP
hit-3SG/2PL/OBL.SG/2PL.IMP	hit-2PL/2PL.IMP
grab/hold-3SG/2PL/OBL.SG/2PL.IMP	grab/hold-2PL/2PL.IMP
hold-3SG/2PL/OBL.SG/2PL.IMP	hold-2PL/2PL.IMP
work-3SG/2PL/OBL.SG/2PL.IMP	work-2PL/2PL.IMP
shut-3SG/2PL/OBL.SG/2PL.IMP	shut-2PL/2PL.IMP
forget-3SG/2PL/OBL.SG/2PL.IMP	forget-2PL/2PL.IMP
sell-3SG/2PL/OBL.SG/2PL.IMP	sell-2PL/2PL.IMP
buy/scare-3SG/2PL/OBL.SG/2PL.IMP	buy/scare-2PL/2PL.IMP
wash-3SG/2PL/OBL.SG/2PL.IMP	wash-2PL/2PL.IMP
spread-3SG/2PL/OBL.SG/2PL.IMP	spread-2PL/2PL.IMP
learn-3SG/2PL/OBL.SG/2PL.IMP	learn-2PL/2PL.IMP
play-3SG/2PL/OBL.SG/2PL.IMP	play-2PL/2PL.IMP
jump-3SG/2PL/OBL.SG/2PL.IMP	jump-2PL/2PL.IMP
cry-3SG/2PL/OBL.SG/2PL.IMP	cry-2PL/2PL.IMP
laugh-3SG/2PL/OBL.SG/2PL.IMP	laugh-2PL/2PL.IMP
burn-3SG/2PL/OBL.SG/2PL.IMP	burn-2PL/2PL.IMP
call-3SG/2PL/OBL.SG/2PL.IMP	call-2PL/2PL.IMP
call/knock-3SG/2PL/OBL.SG/2PL.IMP	call/knock-2PL/2PL.IMP
send-3SG/2PL/OBL.SG/2PL.IMP	send-2PL/2PL.IMP
pull-3SG/2PL/OBL.SG/2PL.IMP	pull-2PL/2PL.IMP
push-3SG/2PL/OBL.SG/2PL.IMP	push-2PL/2PL.IMP
break-3SG/2PL/OBL.SG/2PL.IMP	break-2PL/2PL.IMP
there.is-PRES-SOC/COND/3PL	there.is-PRES-COND
do/make-1PL/NEG/OBL.PL/DEF	do/make-1PL
honor-COP/PROG	honor-COP
free-COP/PROG	free-COP
we-COP/COP-1PL-PRES	we-COP
strong/courageous/hard-GEN/M/OBL.SG	strong-M
good/beautiful-GEN/M/OBL.SG	good/beautiful-M
black-GEN/M/OBL.SG	black-M
blue-GEN/M/OBL.SG	blue-M
clean-GEN/M/OBL.SG	clean-M
cold-GEN/M/OBL.SG	cold-M
cold/thirsty-GEN/M/OBL.SG	cold/thirsty-M
crazy-GEN/M/OBL.SG	crazy-M
dark-GEN/M/OBL.SG	dark-M
dirty-GEN/M/OBL.SG	dirty-M
dry-GEN/M/OBL.SG	dry-M
early-GEN/M/OBL.SG	early-M
exceed/bad-GEN/M/OBL.SG	exceed/bad-M
fat-GEN/M/OBL.SG	fat-M
full-GEN/M/OBL.SG	full-M
gold-GEN/M/OBL.SG	gold-M
good-GEN/M/OBL.SG	good-M
good/clever-GEN/M/OBL.SG	good/clever-M
green-GEN/M/OBL.SG	green-M
happy-GEN/M/OBL.SG	happy-M
hard-GEN/M/OBL.SG	hard-M
high-GEN/M/OBL.SG	high-M
hot-GEN/M/OBL.SG	hot-M
kind-GEN/M/OBL.SG	kind-M
late-GEN/M/OBL.SG	late-M
light-GEN/M/OBL.SG	light-M
long-GEN/M/OBL.SG	long-M
low-GEN/M/OBL.SG	low-M
new-GEN/M/OBL.SG	new-M
new/now-GEN/M/OBL.SG	new-M
old-GEN/M/OBL.SG	old-M
old/big-GEN/M/OBL.SG	old/big-M
only/good-GEN/M/OBL.SG	good-M
poor-GEN/M/OBL.SG	poor-M
red-GEN/M/OBL.SG	red-M
rich-GEN/M/OBL.SG	rich-M
short-GEN/M/OBL.SG	short-M
small-GEN/M/OBL.SG	small-M
smooth-GEN/M/OBL.SG	smooth-M
sour-GEN/M/OBL.SG	sour-M
strong-GEN/M/OBL.SG	strong-M
sweet-GEN/M/OBL.SG	sweet-M
thin-GEN/M/OBL.SG	thin-M
tired-GEN/M/OBL.SG	tired-M
weak-GEN/M/OBL.SG	weak-M
wet-GEN/M/OBL.SG	wet-M
white-GEN/M/OBL.SG	white-M
wide-GEN/M/OBL.SG	wide-M
yellow-GEN/M/OBL.SG	yellow-M
turn.around/far-GEN/M/OBL.SG	far-M
young/brave/handsome-GEN/M/OBL.SG	young/brave/handsome-M
become.big/big-GEN/M/OBL.SG	big-M
strong/courageous/hard-F/3SG/2SG.PRES/2SG.IMP	strong/courageous/hard-F
good/beautiful-F/3SG/2SG.PRES/2SG.IMP	good/beautiful-F
black-F/3SG/2SG.PRES/2SG.IMP	black-F
blue-F/3SG/2SG.PRES/2SG.IMP	blue-F
clean-F/3SG/2SG.PRES/2SG.IMP	clean-F
cold-F/3SG/2SG.PRES/2SG.IMP	cold-F
cold/thirsty-F/3SG/2SG.PRES/2SG.IMP	cold/thirsty-F
crazy-F/3SG/2SG.PRES/2SG.IMP	crazy-F
dark-F/3SG/2SG.PRES/2SG.IMP	dark-F
dirty-F/3SG/2SG.PRES/2SG.IMP	dirty-F
dry-F/3SG/2SG.PRES/2SG.IMP	dry-F
early-F/3SG/2SG.PRES/2SG.IMP	early-F
exceed/bad-F/3SG/2SG.PRES/2SG.IMP	bad-F
fat-F/3SG/2SG.PRES/2SG.IMP	fat-F
full-F/3SG/2SG.PRES/2SG.IMP	full-F
gold-F/3SG/2SG.PRES/2SG.IMP	gold-F
good-F/3SG/2SG.PRES/2SG.IMP	good-F
good/clever-F/3SG/2SG.PRES/2SG.IMP	good/clever-F
green-F/3SG/2SG.PRES/2SG.IMP	green-F
happy-F/3SG/2SG.PRES/2SG.IMP	happy-F
hard-F/3SG/2SG.PRES/2SG.IMP	hard-F
high-F/3SG/2SG.PRES/2SG.IMP	high-F
hot-F/3SG/2SG.PRES/2SG.IMP	hot-F
kind-F/3SG/2SG.PRES/2SG.IMP	kind-F
late-F/3SG/2SG.PRES/2SG.IMP	late-F
light-F/3SG/2SG.PRES/2SG.IMP	light-F
long-F/3SG/2SG.PRES/2SG.IMP	long-F
low-F/3SG/2SG.PRES/2SG.IMP	low-F
new-F/3SG/2SG.PRES/2SG.IMP	new-F
new/now-F/3SG/2SG.PRES/2SG.IMP	new-F
old-F/3SG/2SG.PRES/2SG.IMP	old-F
old/big-F/3SG/2SG.PRES/2SG.IMP	old/big-F
only/good-F/3SG/2SG.PRES/2SG.IMP	good-F
poor-F/3SG/2SG.PRES/2SG.IMP	poor-F
red-F/3SG/2SG.PRES/2SG.IMP	red-F
rich-F/3SG/2SG.PRES/2SG.IMP	rich-F
short-F/3SG/2SG.PRES/2SG.IMP	short-F
small-F/3SG/2SG.PRES/2SG.IMP	small-F
smooth-F/3SG/2SG.PRES/2SG.IMP	smooth-F
sour-F/3SG/2SG.PRES/2SG.IMP	sour-F
strong-F/3SG/2SG.PRES/2SG.IMP	strong-F
sweet-F/3SG/2SG.PRES/2SG.IMP	sweet-F
thin-F/3SG/2SG.PRES/2SG.IMP	thin-F
tired-F/3SG/2SG.PRES/2SG.IMP	tired-F
weak-F/3SG/2SG.PRES/2SG.IMP	weak-F
wet-F/3SG/2SG.PRES/2SG.IMP	wet-F
white-F/3SG/2SG.PRES/2SG.IMP	white-F
wide-F/3SG/2SG.PRES/2SG.IMP	wode-F
yellow-F/3SG/2SG.PRES/2SG.IMP	yellow-F
young/brave/handsome-F/3SG/2SG.PRES/2SG.IMP	young/brave/handsome-F
become.big/big-F/3SG/2SG.PRES/2SG.IMP	big-F
turn.around/far-F/3SG/2SG.PRES/2SG.IMP	far-F
say/good-more	good-more
new/now-more	new-more
only/good-more	good-more
become.big/big-more	big-more
SG-1SG-PRES/2SG.PRES/PL	SG-1SG-PRES
SG-2SG-PRES/2SG.PRES/PL	SG-2SG-PRES
SG-3SG-PRES/2SG.PRES/PL	SG-3SG-PRES
SG-1PL-PRES/2SG.PRES/PL	SG-1PL-PRES
SG-2PL-PRES/2SG.PRES/PL	SG-2PL-PRES
SG-3PL-PRES/2SG.PRES/PL	SG-3PL-PRES
PL-1SG-PRES/2SG.PRES/PL	PL-1SG-PRES
PL-2SG-PRES/2SG.PRES/PL	PL-2SG-PRES
PL-3SG-PRES/2SG.PRES/PL	PL-3SG-PRES
PL-1PL-PRES/2SG.PRES/PL	PL-1PL-PRES
PL-2PL-PRES/2SG.PRES/PL	PL-2PL-PRES
PL-3PL-PRES/2SG.PRES/PL	PL-3PL-PRES
strong/courageous/hard-PRES/2SG.PRES/PL	strong-PRES
good/beautiful-PRES/2SG.PRES/PL	good/beautiful-PRES
black-PRES/2SG.PRES/PL	black-PRES
blue-PRES/2SG.PRES/PL	blue-PRES
clean-PRES/2SG.PRES/PL	clean-PRES
cold-PRES/2SG.PRES/PL	cold-PRES
cold/thirsty-PRES/2SG.PRES/PL	cold/thirsty-PRES
crazy-PRES/2SG.PRES/PL	crazy-PRES
dark-PRES/2SG.PRES/PL	dark-PRES
dirty-PRES/2SG.PRES/PL	dirty-PRES
dry-PRES/2SG.PRES/PL	dry-PRES
early-PRES/2SG.PRES/PL	early-PRES
exceed/bad-PRES/2SG.PRES/PL	exceed/bad-PRES
fat-PRES/2SG.PRES/PL	fat-PRES
full-PRES/2SG.PRES/PL	full-PRES
gold-PRES/2SG.PRES/PL	gold-PRES
good-PRES/2SG.PRES/PL	good-PRES
good/clever-PRES/2SG.PRES/PL	good/clever-PRES
green-PRES/2SG.PRES/PL	green-PRES
happy-PRES/2SG.PRES/PL	happy-PRES
hard-PRES/2SG.PRES/PL	hard-PRES
high-PRES/2SG.PRES/PL	high-PRES
hot-PRES/2SG.PRES/PL	hot-PRES
kind-PRES/2SG.PRES/PL	kind-PRES
late-PRES/2SG.PRES/PL	late-PRES
light-PRES/2SG.PRES/PL	light-PRES
long-PRES/2SG.PRES/PL	long-PRES
low-PRES/2SG.PRES/PL	low-PRES
new-PRES/2SG.PRES/PL	new-PRES
new/now-PRES/2SG.PRES/PL	new-PRES
old-PRES/2SG.PRES/PL	old-PRES
old/big-PRES/2SG.PRES/PL	old/big-PRES
only/good-PRES/2SG.PRES/PL	good-PRES
poor-PRES/2SG.PRES/PL	poor-PRES
red-PRES/2SG.PRES/PL	red-PRES
rich-PRES/2SG.PRES/PL	rich-PRES
short-PRES/2SG.PRES/PL	short-PRES
small-PRES/2SG.PRES/PL	small-PRES
smooth-PRES/2SG.PRES/PL	smooth-PRES
sour-PRES/2SG.PRES/PL	sour-PRES
strong-PRES/2SG.PRES/PL	strong-PRES
sweet-PRES/2SG.PRES/PL	sweet-PRES
thin-PRES/2SG.PRES/PL	thin-PRES
tired-PRES/2SG.PRES/PL	tired-PRES
weak-PRES/2SG.PRES/PL	weak-PRES
wet-PRES/2SG.PRES/PL	wet-PRES
white-PRES/2SG.PRES/PL	white-PRES
wide-PRES/2SG.PRES/PL	wide-PRES
yellow-PRES/2SG.PRES/PL	yellow-PRES
turn.around/far-PRES/2SG.PRES/PL	far-PRES
young/brave/handsome-PRES/2SG.PRES/PL	young/brave/handsome-PRES
become.big/big-PRES/2SG.PRES/PL	big-PRES
strong/courageous/hard-COP/PROG	strong-COP
good/beautiful-COP/PROG	good/beautiful-COP
black-COP/PROG	black-COP
blue-COP/PROG	blue-COP
clean-COP/PROG	clean-COP
cold-COP/PROG	cold-COP
cold/thirsty-COP/PROG	cold/thirsty-COP
dark-COP/PROG	dark-COP
dirty-COP/PROG	dirty-COP
dry-COP/PROG	dry-COP
early-COP/PROG	early-COP
exceed/bad-COP/PROG	exceed/bad-COP
fat-COP/PROG	fat-COP
full-COP/PROG	full-COP
gold-COP/PROG	gold-COP
good-COP/PROG	good-COP
good/clever-COP/PROG	good/clever-COP
green-COP/PROG	green-COP
happy-COP/PROG	happy-COP
hard-COP/PROG	hard-COP
high-COP/PROG	high-COP
hot-COP/PROG	hot-COP
kind-COP/PROG	kind-COP
late-COP/PROG	late-COP
light-COP/PROG	light-COP
long-COP/PROG	long-COP
low-COP/PROG	low-COP
new-COP/PROG	new-COP
new/now-COP/PROG	new-COP
old-COP/PROG	old-COP
old/big-COP/PROG	old/big-COP
only/good-COP/PROG	good-COP
poor-COP/PROG	poor-COP
red-COP/PROG	red-COP
rich-COP/PROG	rich-COP
short-COP/PROG	short-COP
small-COP/PROG	small-COP
smooth-COP/PROG	smooth-COP
sour-COP/PROG	sour-COP
strong-COP/PROG	strong-COP
sweet-COP/PROG	sweet-COP
thin-COP/PROG	thin-COP
tired-COP/PROG	tired-COP
weak-COP/PROG	weak-COP
wet-COP/PROG	wet-COP
white-COP/PROG	white-COP
wide-COP/PROG	wide-COP
yellow-COP/PROG	yellow-COP
young/brave/handsome-COP/PROG	young/brave/handsome-COP
become.big/big-COP/PROG	big-COP
turn.around/far-COP/PROG	far-COP
apply/get.closer-take/NEG-COP/PROG	apply/get.closer-NEG-PROG
hall-REM/2SG.PRES/2SG/INDEF/CAUS	hall-REM/INDEF
day-1SG/LOC	day-LOC
with/at/fear-DEF	with/at-DEF
car-LOC/1SG	car-LOC
girl-1SG/LOC	girl-1SG/LOC
do-1SG/LOC	do-1SG
non.Dom.man-1PL/NEG/OBL.PL/DEF	non.Dom.man-OBL.PL/DEF
skin-PRES/2SG.PRES/PL	skin-PRES
dress-3SG/2PL/OBL.SG/2PL.IMP	dress-3SG/OBL.SG
day-3SG/2PL/OBL.SG/2PL.IMP	day-3SG/OBL.SG
car-3SG/2PL/OBL.SG/2PL.IMP	car-3SG/OBL.SG
be.angry/inside-BEN	inside-BEN
family-GEN/M/OBL.SG	family-GEN/OBL.SG
PRES/2SG.PRES/PL-ABL	PL-ABL
apply/get.closer-take/NEG	apply/get.closer-NEG
-LOC/1SG-COP/PROG	-LOC-COP
period-REM/2SG/INDEF/CAUS	period-REM/INDEF
building-REM/2SG/INDEF/CAUS	building-REM/INDEF
house-3SG/2PL/OBL.SG/2PL.IMP	house-3SG/OBL.SG
Lebanon-1SG/LOC	Lebanon-LOC
good/beautiful-REM/2SG/INDEF/CAUS	good/beautiful-REM/INDEF
house-REM/2SG/INDEF/CAUS	house-REM/INDEF
period-REM/2SG/INDEF/CAUS	period-REM/INDEF
we-COP/PROG	we-COP
do/make/FUT-PROG	do/make-PROG
ticket-REM/2SG/INDEF/CAUS	ticket-REM/INDEF
year-REM/2SG/INDEF/CAUS	year-REM/INDEF
say/good-3PL	say-3PL
say/good-2PL	say-2PL
say/good-1PL	say-1PL
say/good-3SG	say-3SG
say/good-2SG	say-2SG
say/good-1SG	say-1SG
week-REM/2SG/INDEF/CAUS	 week-REM/INDEF
ticket-3SG/2PL/OBL.SG/2PL.IMP	ticket-3SG/OBL.SG
Algeria-1SG/LOC	Algeria-LOC
Lebanon-1SG/LOC	Lebanon-LOC
Egypt-1SG/LOC	Egypt-LOC
1SG/LOC-COP/PROG	LOC-COP
first-1SG/LOC	first-LOC
Algeria-1SG/LOC	Algeria-LOC
turn.around/far-VITR	turn.around-VITR
country-REM/2SG/INDEF/CAUS	country-REM/INDEF
border-3SG/2PL/OBL.SG/2PL.IMP	border-3SG/OBL.SG
I-COP/PROG	I-COP
SG-1SG-REM/2SG/INDEF/CAUS	SG-1SG-REM/INDEF
SG-3SG-REM/2SG/INDEF/CAUS	SG-3SG-REM/INDEF
SG-2SG-REM/2SG/INDEF/CAUS	SG-2SG-REM/INDEF
PL-1SG-REM/2SG/INDEF/CAUS	PL-1SG-REM/INDEF
PL-3SG-REM/2SG/INDEF/CAUS	PL-3SG-REM/INDEF
PL-2SG-REM/2SG/INDEF/CAUS	PL-2SG-REM/INDEF
SG-1PL-REM/2SG/INDEF/CAUS	SG-1PL-REM/INDEF
SG-3PL-REM/2SG/INDEF/CAUS	SG-3PL-REM/INDEF
SG-2PL-REM/2SG/INDEF/CAUS	SG-2PL-REM/INDEF
PL-1PL-REM/2SG/INDEF/CAUS	PL-1PL-REM/INDEF
PL-3PL-REM/2SG/INDEF/CAUS	PL-3PL-REM/INDEF
PL-2PL-REM/2SG/INDEF/CAUS	PL-2PL-REM/INDEF
way-3SG/2PL/OBL.SG/2PL.IMP	way-3SG/OBL.SG
village/two year	two year
residence-3SG/2PL/OBL.SG/2PL.IMP	residence-3SG/OBL.SG
torment-3SG/2PL/OBL.SG/2PL.IMP	torment-3SG/OBL.SG
work/thing-PRES/2SG.PRES/PL	work/thing-PRES/PL
LOC-COP/PROG	LOC-COP
INDEF-PRES/2SG.PRES/PL	INDEF-PRES
week-REM/2SG/INDEF/CAUS	week-REM/INDEF
country-REM/2SG/INDEF/CAUS	country-REM/INDEF
border-3SG/2PL/OBL.SG/2PL.IMP	border-3SG/OBL.SG
torture/tired-PFV	tired-PFV
India-COP/PROG	India-COP
flee-2SG/3SG	flee-3SG
village/two hundred	two hundred
village/two thousand	two thousand
one-1PL/NEG/OBL.PL/DEF	one-OBL.PL
thousand-1SG/LOC	thousand-LOC
Dom-REM/2SG/INDEF/CAUS	Dom-REM/INDEF
language-3SG/2PL/OBL.SG/2PL.IMP	language-3SG/OBL.SG
Dom-COP/PROG	Dom-COP
Dom-PRES/2SG.PRES/PL	Dom-PRES/PL
mother-VITR/INDEF/3PL/REM/and/2SG	mother-INDEF/REM/and
PL-REM/2SG/INDEF/CAUS	PL-REM
owner-REM/2SG/INDEF/CAUS	owner-REM/INDEF
DER-REM/2SG/INDEF/CAUS	DER-REM
sweet-REM/2SG/INDEF/CAUS	sweet-REM
alive-REM/2SG/INDEF/CAUS	alive-REM
PROG-1PL/NEG/OBL.PL/DEF	PROG-1PL
SG-3SG-1SG/LOC	SG-3SG-LOC
bring-1SG/LOC	bring-1SG
want-1SG/LOC	want-1SG
say-1SG/LOC	say-1SG
go-1SG/LOC	go-1SG
know/spray-1SG/LOC	know/spray-1SG
do/make-1SG/LOC	do/make-1SG
come-1SG/LOC	come-1SG
see-1SG/LOC	see-1SG
look.after-1SG/LOC	look.after-1SG
give.birth-1SG/LOC	give.birth-1SG
put/give-1SG/LOC	put/give-1SG
take-1SG/LOC	take-1SG
say-1SG/LOC	say-1SG
bring-1SG/LOC	bring-1SG
bring.back-1SG/LOC	bring.back-1SG
eat-1SG/LOC	eat-1SG
eat/vomit-1SG/LOC	eat/vomit-1SG
drink-1SG/LOC	drink-1SG
return-1SG/LOC	return-1SG
hear/knead-1SG/LOC	hear/knead-1SG
hear-1SG/LOC	hear-1SG
sit/live-1SG/LOC	sit/live-1SG
sleep-1SG/LOC	sleep-1SG
stand-1SG/LOC	stand-1SG
stay/wait/stand.up-1SG/LOC	stay/wait/stand.up-1SG
stand.up-1SG/LOC	stand.up-1SG
run-1SG/LOC	run-1SG
run.away-1SG/LOC	run.away-1SG
fall-1SG/LOC	fall-1SG
die-1SG/LOC	die-1SG
exit-1SG/LOC	exit-1SG
enter-1SG/LOC	enter-1SG
open/hit-1SG/LOC	open/hit-1SG
hit-1SG/LOC	hit-1SG
grab/hold-1SG/LOC	grab/hold-1SG
hold-1SG/LOC	hold-1SG
work-1SG/LOC	work-1SG
shut-1SG/LOC	shut-1SG
forget-1SG/LOC	forget-1SG
sell-1SG/LOC	sell-1SG
buy/scare-1SG/LOC	buy/scare-1SG
wash-1SG/LOC	wash-1SG
spread-1SG/LOC	spread-1SG
learn-1SG/LOC	learn-1SG
play-1SG/LOC	play-1SG
jump-1SG/LOC	jump-1SG
cry-1SG/LOC	cry-1SG
laugh-1SG/LOC	laugh-1SG
burn-1SG/LOC	burn-1SG
call-1SG/LOC	call-1SG
call/knock-1SG/LOC	call/knock-1SG
send-1SG/LOC	send-1SG
pull-1SG/LOC	pull-1SG
push-1SG/LOC	push-1SG
break-1SG/LOC	break-1SG
week-1SG/LOC	week-LOC
people-1PL/NEG/OBL.PL/DEF	people-OBL.PL/DEF
know-PRES/2SG.PRES/PL	know-PRES/2SG.PRES
man-PRES/2SG.PRES/PL	man-PRES/PL
people-PRES/2SG.PRES/PL	people-PRES/PL
what-PRES/2SG.PRES/PL	what-PRES/PL
know-PRES/2SG.PRES/PL	know-2SG.PRES
do/FUT-COP/PROG	do-PROG
say/good-NEG-VTR	say-NEG-VTR
go-LOC/1SG	go-1SG
know-COP/PROG	know-PROG
say/good-PFV	say-PFV
annoy-COP/PROG	annoy-PROG
grandmother-SG-2SG/-VITR-3SG	grandmother-SG-2SG
village/two time	two time
find/search-COP/PROG	find/search-PROG
Syria-LOC/1SG	Syria-LOC
ruin-PRES/2SG.PRES/PL	ruin-PRES/2SG.PRES
do/make/FUT-COP/PROG	do/make-PROG
mother-SG-2SG/-VITR-3SG	mother-SG-2SG
girl-3SG/2PL/OBL.SG/2PL.IMP	girl-3SG/OBL.SG
henna-3SG/2PL/OBL.SG/2PL.IMP	henna-3SG/OBL.SG
wedding-3SG/2PL/OBL.SG/2PL.IMP	wedding-3SG/OBL.SG
this-VITR/INDEF/3PL/REM/and/2SG	this-REM
how-REM/2SG/INDEF/CAUS	how-REM
drum-PRES/2SG.PRES/PL	drum-PRES/PL
child-SG-2SG/-VITR-3SG	child-SG-2SG
put-COP/PROG	put-PROG
how-COP/PROG	how-COP
destroy-COP/PROG	destroy-PROG
good-REM/2SG/INDEF/CAUS	good-REM/INDEF
story-REM/2SG/INDEF/CAUS	story-REM/INDEF
do/make-REM/2SG/INDEF/CAUS	do/make-REM/2SG/CAUS
existing-REM/2SG/INDEF/CAUS	existing-REM
come-REM/2SG/INDEF/CAUS	come-REM/2SG
want-REM/2SG/INDEF/CAUS	want-REM/2SG/CAUS
say-REM/2SG/INDEF/CAUS	say-REM/2SG/CAUS
go-REM/2SG/INDEF/CAUS	go-REM/2SG/CAUS
know/spray-REM/2SG/INDEF/CAUS	know/spray-REM/2SG/CAUS
do/make-REM/2SG/INDEF/CAUS	do/make-REM/2SG/CAUS
come-REM/2SG/INDEF/CAUS	come-REM/2SG/CAUS
see-REM/2SG/INDEF/CAUS	see-REM/2SG/CAUS
look.after-REM/2SG/INDEF/CAUS	look.after-REM/2SG/CAUS
give.birth-REM/2SG/INDEF/CAUS	give.birth-REM/2SG/CAUS
put/give-REM/2SG/INDEF/CAUS	put/give-REM/2SG/CAUS
take-REM/2SG/INDEF/CAUS	take-REM/2SG/CAUS
say-REM/2SG/INDEF/CAUS	say-REM/2SG/CAUS
bring-REM/2SG/INDEF/CAUS	bring-REM/2SG/CAUS
bring.back-REM/2SG/INDEF/CAUS	bring.back-REM/2SG/CAUS
eat-REM/2SG/INDEF/CAUS	eat-REM/2SG/CAUS
eat/vomit-REM/2SG/INDEF/CAUS	eat/vomit-REM/2SG/CAUS
drink-REM/2SG/INDEF/CAUS	drink-REM/2SG/CAUS
return-REM/2SG/INDEF/CAUS	return-REM/2SG/CAUS
hear/knead-REM/2SG/INDEF/CAUS	hear/knead-REM/2SG/CAUS
hear-REM/2SG/INDEF/CAUS	hear-REM/2SG/CAUS
sit/live-REM/2SG/INDEF/CAUS	sit/live-REM/2SG/CAUS
sleep-REM/2SG/INDEF/CAUS	sleep-REM/2SG/CAUS
stand-REM/2SG/INDEF/CAUS	stand-REM/2SG/CAUS
stay/wait/stand.up-REM/2SG/INDEF/CAUS	stay/wait/stand.up-REM/2SG/CAUS
stand.up-REM/2SG/INDEF/CAUS	stand.up-REM/2SG/CAUS
run-REM/2SG/INDEF/CAUS	run-REM/2SG/CAUS
run.away-REM/2SG/INDEF/CAUS	run.away-REM/2SG/CAUS
fall-REM/2SG/INDEF/CAUS	fall-REM/2SG/CAUS
die-REM/2SG/INDEF/CAUS	die-REM/2SG/CAUS
exit-REM/2SG/INDEF/CAUS	exit-REM/2SG/CAUS
enter-REM/2SG/INDEF/CAUS	enter-REM/2SG/CAUS
open/hit-REM/2SG/INDEF/CAUS	open/hit-REM/2SG/CAUS
hit-REM/2SG/INDEF/CAUS	hit-REM/2SG/CAUS
grab/hold-REM/2SG/INDEF/CAUS	grab/hold-REM/2SG/CAUS
hold-REM/2SG/INDEF/CAUS	hold-REM/2SG/CAUS
work-REM/2SG/INDEF/CAUS	work-REM/2SG/CAUS
shut-REM/2SG/INDEF/CAUS	shut-REM/2SG/CAUS
forget-REM/2SG/INDEF/CAUS	forget-REM/2SG/CAUS
sell-REM/2SG/INDEF/CAUS	sell-REM/2SG/CAUS
buy/scare-REM/2SG/INDEF/CAUS	buy/scare-REM/2SG/CAUS
wash-REM/2SG/INDEF/CAUS	wash-REM/2SG/CAUS
spread-REM/2SG/INDEF/CAUS	spread-REM/2SG/CAUS
learn-REM/2SG/INDEF/CAUS	learn-REM/2SG/CAUS
play-REM/2SG/INDEF/CAUS	play-REM/2SG/CAUS
jump-REM/2SG/INDEF/CAUS	jump-REM/2SG/CAUS
cry-REM/2SG/INDEF/CAUS	cry-REM/2SG/CAUS
laugh-REM/2SG/INDEF/CAUS	laugh-REM/2SG/CAUS
burn-REM/2SG/INDEF/CAUS	burn-REM/2SG/CAUS
call-REM/2SG/INDEF/CAUS	call-REM/2SG/CAUS
call/knock-REM/2SG/INDEF/CAUS	call/knock-REM/2SG/CAUS
send-REM/2SG/INDEF/CAUS	send-REM/2SG/CAUS
pull-REM/2SG/INDEF/CAUS	pull-REM/2SG/CAUS
push-REM/2SG/INDEF/CAUS	push-REM/2SG/CAUS
break-REM/2SG/INDEF/CAUS	break-REM/2SG/CAUS
school-SG-2SG/-VITR-3SG	school-SG-2SG
see-PRES/2SG.PRES/PL	see-PRES/2SG.PRES
want-PRES/2SG.PRES/PL	want-PRES/2SG.PRES
say-PRES/2SG.PRES/PL	say-PRES/2SG.PRES
go-PRES/2SG.PRES/PL	go-PRES/2SG.PRES
know/spray-PRES/2SG.PRES/PL	know/spray-PRES/2SG.PRES
do/make-PRES/2SG.PRES/PL	do/make-PRES/2SG.PRES
come-PRES/2SG.PRES/PL	come-PRES/2SG.PRES
see-PRES/2SG.PRES/PL	see-PRES/2SG.PRES
look.after-PRES/2SG.PRES/PL	look.after-PRES/2SG.PRES
give.birth-PRES/2SG.PRES/PL	give.birth-PRES/2SG.PRES
put/give-PRES/2SG.PRES/PL	put/give-PRES/2SG.PRES
take-PRES/2SG.PRES/PL	take-PRES/2SG.PRES
say-PRES/2SG.PRES/PL	say-PRES/2SG.PRES
bring-PRES/2SG.PRES/PL	bring-PRES/2SG.PRES
bring.back-PRES/2SG.PRES/PL	bring.back-PRES/2SG.PRES
eat-PRES/2SG.PRES/PL	eat-PRES/2SG.PRES
eat/vomit-PRES/2SG.PRES/PL	eat/vomit-PRES/2SG.PRES
drink-PRES/2SG.PRES/PL	drink-PRES/2SG.PRES
return-PRES/2SG.PRES/PL	return-PRES/2SG.PRES
hear/knead-PRES/2SG.PRES/PL	hear/knead-PRES/2SG.PRES
hear-PRES/2SG.PRES/PL	hear-PRES/2SG.PRES
sit/live-PRES/2SG.PRES/PL	sit/live-PRES/2SG.PRES
sleep-PRES/2SG.PRES/PL	sleep-PRES/2SG.PRES
stand-PRES/2SG.PRES/PL	stand-PRES/2SG.PRES
stay/wait/stand.up-PRES/2SG.PRES/PL	stay/wait/stand.up-PRES/2SG.PRES
stand.up-PRES/2SG.PRES/PL	stand.up-PRES/2SG.PRES
run-PRES/2SG.PRES/PL	run-PRES/2SG.PRES
run.away-PRES/2SG.PRES/PL	run.away-PRES/2SG.PRES
fall-PRES/2SG.PRES/PL	fall-PRES/2SG.PRES
die-PRES/2SG.PRES/PL	die-PRES/2SG.PRES
exit-PRES/2SG.PRES/PL	exit-PRES/2SG.PRES
enter-PRES/2SG.PRES/PL	enter-PRES/2SG.PRES
open/hit-PRES/2SG.PRES/PL	open/hit-PRES/2SG.PRES
hit-PRES/2SG.PRES/PL	hit-PRES/2SG.PRES
grab/hold-PRES/2SG.PRES/PL	grab/hold-PRES/2SG.PRES
hold-PRES/2SG.PRES/PL	hold-PRES/2SG.PRES
work-PRES/2SG.PRES/PL	work-PRES/2SG.PRES
shut-PRES/2SG.PRES/PL	shut-PRES/2SG.PRES
forget-PRES/2SG.PRES/PL	forget-PRES/2SG.PRES
sell-PRES/2SG.PRES/PL	sell-PRES/2SG.PRES
buy/scare-PRES/2SG.PRES/PL	buy/scare-PRES/2SG.PRES
wash-PRES/2SG.PRES/PL	wash-PRES/2SG.PRES
spread-PRES/2SG.PRES/PL	spread-PRES/2SG.PRES
learn-PRES/2SG.PRES/PL	learn-PRES/2SG.PRES
play-PRES/2SG.PRES/PL	play-PRES/2SG.PRES
jump-PRES/2SG.PRES/PL	jump-PRES/2SG.PRES
cry-PRES/2SG.PRES/PL	cry-PRES/2SG.PRES
laugh-PRES/2SG.PRES/PL	laugh-PRES/2SG.PRES
burn-PRES/2SG.PRES/PL	burn-PRES/2SG.PRES
call-PRES/2SG.PRES/PL	call-PRES/2SG.PRES
call/knock-PRES/2SG.PRES/PL	call/knock-PRES/2SG.PRES
send-PRES/2SG.PRES/PL	send-PRES/2SG.PRES
pull-PRES/2SG.PRES/PL	pull-PRES/2SG.PRES
push-PRES/2SG.PRES/PL	push-PRES/2SG.PRES
break-PRES/2SG.PRES/PL	break-PRES/2SG.PRES
something-PRES/2SG.PRES/PL	something-PRES/PL
NEG-COP/PROG	NEG-COP
put-COP/PROG	put-PROG
single-PRES/2SG.PRES/PL	single-PRES
1PL/NEG/OBL.PL/DEF-VTR	NEG-VTR
God-3SG/2PL/OBL.SG/2PL.IMP	God-3SG/OBL.SG
messenger-3SG/2PL/OBL.SG/2PL.IMP	messenger-3SG/OBL.SG
funeral-3SG/2PL/OBL.SG/2PL.IMP	funeral-3SG/OBL.SG
bring-REM/2SG/INDEF/CAUS	bring-2SG/CAUS
sacrifice-REM/2SG/INDEF/CAUS	sacrifice-2SG/CAUS
kill-REM/2SG/INDEF/CAUS	kill-2SG 
sacrifice-3SG/2PL/OBL.SG/2PL.IMP	sacrifice-3SG/OBL.SG
work/thing-3SG/2PL/OBL.SG/2PL.IMP	work/thing-3SG/OBL.SG
star-REM/2SG/INDEF/CAUS	star-REM/INDEF
soul-REM/2SG/INDEF/CAUS	soul-REM/INDEF
eye-GEN/M/OBL.SG	eye-GEN/OBL.SG
father-3SG/2PL/OBL.SG/2PL.IMP	father-3SG/OBL.SG
bride-3SG/2PL/OBL.SG/2PL.IMP	bride-3SG/OBL.SG
groom-3SG/2PL/OBL.SG/2PL.IMP	groom-3SG/OBL.SG
man-GEN/M/OBL.SG	man-GEN/OBL.SG
strange-3SG/2PL/OBL.SG/2PL.IMP	strange-OBL.SG
say/good-NEG	say-NEG
wrong-PRES/2SG.PRES/PL	wrong-PRES
place/bed-REM/2SG/INDEF/CAUS	place/bed-REM/INDEF
generous-REM/2SG/INDEF/CAUS	generous-REM/INDEF
happy-REM/2SG/INDEF/CAUS	happy-REM/INDEF
comfortable-REM/2SG/INDEF/CAUS	comfortable-REM
comfortable-COP/PROG	comfortable-COP
take-VITR/INDEF/3PL/REM/and/2SG	take-VITR/REM/2SG
head/secret-SG-1SG	head/secret-SG-1SG
day-REM/2SG/INDEF/CAUS	day-REM/INDEF
happy-COP/PROG	happy-COP
uncle-REM/2SG/INDEF/CAUS	uncle-REM/INDEF
sister-COP/PROG	sister-COP
brother-COP/PROG	brother-COP
open/hit-VITR/INDEF/3PL/REM/and/2SG	open/hit-VITR/REM/2SG
boy-1PL/NEG/OBL.PL/DEF	boy-OBL.PL/DEF
remove-1SG/LOC	remove-1SG
go.FUT-REM/2SG/INDEF/CAUS	go.FUT-REM/2SG/CAUS
go.FUT-LOC/1SG	go.FUT-1SG
1SG-COP/PROG	1SG-COP
2SG-COP/PROG	2SG-COP
3SG-COP/PROG	3SG-COP
1PL-COP/PROG	1PL-COP
2PL-COP/PROG	2PL-COP
3PL-COP/PROG	3PL-COP
lesson-REM/2SG/INDEF/CAUS	lesson-REM/INDEF
area-REM/2SG/INDEF/CAUS	area-REM/INDEF
now-1SG/LOC	now-LOC
PL-PRES/2SG.PRES/PL	PL-PRES
do/make-VITR/INDEF/3PL/REM/and/2SG	do/make-VITR/REM/2SG
pot-VITR/INDEF/3PL/REM/and/2SG	pot-INDEF/REM/and
tea-GEN/M/OBL.SG	tea-GEN/OBL.SG
tray-REM/2SG/INDEF/CAUS	tray-REM/INDEF
Dom-1PL/NEG/OBL.PL/DEF	Dom-OBL.PL/DEF
for-2SG-PRES/2SG.PRES/PL	for-2SG-PRES
nut-GEN/M/OBL.SG	nut-GEN/OBL.SG
bag-REM/2SG/INDEF/CAUS	bag-REM/INDEF
lift-1PL/NEG/OBL.PL/DEF	lift-1PL
sell-VITR/INDEF/3PL/REM/and/2SG-3PL	sell-VITR-3PL
where-COP/PROG	where-COP
leather/skin-REM/2SG/INDEF/CAUS	leather/skin-REM/INDEF
time-REM/2SG/INDEF/CAUS	time-REM/INDEF
both/couple.of-REM/2SG/INDEF/CAUS	both/couple.of-REM/INDEF
thousand-1PL/NEG/OBL.PL/DEF	thousand-OBL.PL/DEF
-SG-2SG/-VITR-3SG-DAT	-SG-2SG-DAT
earring-REM/2SG/INDEF/CAUS	earring-REM/INDEF
year-PRES/2SG.PRES/PL	year-PRES/PL
something-REM/2SG/INDEF/CAUS	something-REM/INDEF
town/market-REM/2SG/INDEF/CAUS	town/market-REM/INDEF
month-REM/2SG/INDEF/CAUS	month-REM/INDEF
soup-VITR/INDEF/3PL/REM/and/2SG	soup-INDEF/REM
bowl-REM/2SG/INDEF/CAUS	bowl-REM/INDEF
crazy-F/3SG/2SG.PRES/2SG.IMP	crazy-F
say/good-SUBJ/PROG-PRES	say-PROG-PRES
yogurt-PRES/2SG.PRES/PL	yogurt-PRES/PL
word-PRES/2SG.PRES/PL	word-PL
clan-REM/2SG/INDEF/CAUS	clan-REM/INDEF
space-REM/2SG/INDEF/CAUS	space-REM/INDEF
INDEF-VITR/INDEF/3PL/REM/and/2SG	INDEF-REM/and
child-COP/PROG	child-COP
child-REM/2SG/INDEF/CAUS	child-REM/INDEF
summer-PRES/2SG.PRES/PL	summer-PRES
months.old-REM/2SG/INDEF/CAUS	months.old-REM
ABL-COP/PROG	-ABL-COP
between-3PL-LOC/1SG	between-3PL-LOC
kilo-VITR/INDEF/3PL/REM/and/2SG	kilo-INDEF/REM
age-REM/2SG/INDEF/CAUS	age-REM/INDEF
1PL-LOC/1SG	1PL-LOC
storm-1PL/NEG/OBL.PL/DEF	storm-OBL.PL/DEF
sacrifice-GEN/M/OBL.SG	sacrifice-GEN/OBL.SG
this-1PL/NEG/OBL.PL/DEF	this-DEF
sacrifice-1PL/NEG/OBL.PL/DEF	sacrifice-OBL.PL/DEF
old.woman-1PL/NEG/OBL.PL/DEF	old.woman-OBL.PL/DEF
hair-1PL/NEG/OBL.PL/DEF	hair-OBL.PL/DEF
old.woman-3SG/2PL/OBL.SG/2PL.IMP	old.woman-3SG/OBL.SG
understand-take/NEG	understand-NEG
dance-COP/PROG	dance-PROG
rain-REM/2SG/INDEF/CAUS	rain-REM/INDEF
fairytale-REM/2SG/INDEF/CAUS	fairytale-REM/INDEF
see-1PL/NEG/OBL.PL/DEF	see-1PL/NEG
be.able-PRES/2SG.PRES/PL	be.able-PRES/2SG.PRES
everything-3SG/2PL/OBL.SG/2PL.IMP	everything-3SG/OBL.SG
house-GEN/M/OBL.SG	house-GEN/OBL.SG
saucer-REM/2SG/INDEF/CAUS	saucer-REM/INDEF
pole-PRES/2SG.PRES/PL	pole-PRES/PL
house-1PL/NEG/OBL.PL/DEF	house-OBL.PL/DEF
tent-PRES/2SG.PRES/PL	tent-PRES/PL
bridge-PRES/2SG.PRES/PL	bridge-PRES/PL
Bedouin-1PL/NEG/OBL.PL/DEF	Bedouin-OBL.PL/DEF
fabric-PRES/2SG.PRES/PL	fabric-PRES/PL
ask-COP/PROG	ask-PROG
moat-REM/2SG/INDEF/CAUS	moat-REM/INDEF
wood-3SG/2PL/OBL.SG/2PL.IMP	wood-3SG/OBL.SG
mattress-1PL/NEG/OBL.PL/DEF	mattress-OBL.PL/DEF
clothes-1PL/NEG/OBL.PL/DEF	clothes-OBL.PL/DEF
PRES-VITR/INDEF/3PL/REM/and/2SG	PRES-REM
next.to-REM/2SG/INDEF/CAUS	next.to-REM/INDEF
donkey-1PL/NEG/OBL.PL/DEF	donkey-OBL.PL/DEF
pick-1PL/NEG/OBL.PL/DEF	pick-1PL/NEG
bring-1PL/NEG/OBL.PL/DEF	bring-1PL/NEG
hear-1PL/NEG/OBL.PL/DEF	to-hear-1PL/NEG
mirror-SIM-REM/2SG/INDEF/CAUS	mirror-SIM-REM
then-VITR/INDEF/3PL/REM/and/2SG	then-REM
both/together-COP/PROG	both/together-COP
way-REM/2SG/INDEF/CAUS	way-REM/INDEF
something-3SG/2PL/OBL.SG/2PL.IMP	something-3SG/OBL.SG
DAT-COP/PROG	DAT-COP
with/at/fear-house	with/at-house
castle/stone.house/room-REM/2SG/INDEF/CAUS	castle/stone.house/room-REM/INDEF
kitchen-REM/2SG/INDEF/CAUS	kitchen-REM/INDEF
PL-3PL-LOC/1SG	PL-3PL-LOC
pregnant-COP/PROG	pregnant-COP
three-REM/2SG/INDEF/CAUS	three-REM
pregnant-REM/2SG/INDEF/CAUS	pregnant-REM
wood-PRES/2SG.PRES/PL	wood-PRES/PL
REM/INDEF-DIR	INDEF-DIR
tent-3SG/2PL/OBL.SG/2PL.IMP	tent-3SG/OBL.SG
with/at/fear-day-REM/INDEF	at-day-INDEF
stone-3SG/2PL/OBL.SG/2PL.IMP	stone-3SG/OBL.SG
non.Dom.man-3SG/2PL/OBL.SG/2PL.IMP	non.Dom.man-OBL.SG
thief-PRES/2SG.PRES/PL	thief-PRES/PL
clothes-SG-2SG/-VITR-3SG	clothes-SG-2SG
dead-3SG/2PL/OBL.SG/2PL.IMP	dead-3SG/OBL.SG
house-SG-2SG/-VITR-3SG-1SG/LOC	house-SG-2SG-LOC
hand-3SG/2PL/OBL.SG/2PL.IMP	hand-3SG/OBL.SG
behind-REM/2SG/INDEF/CAUS	behind-REM
ABL-VITR/INDEF/3PL/REM/and/2SG	ABL-REM
something-1PL/NEG/OBL.PL/DEF	something-OBL.PL/DEF
REL-3SG/2PL/OBL.SG/2PL.IMP	REL-OBL.SG
man-1PL/NEG/OBL.PL/DEF	man-OBL.PL/DEF
ground-REM/2SG/INDEF/CAUS	ground-REM/INDEF
small-REM/2SG/INDEF/CAUS	small-REM/INDEF
ground-3SG/2PL/OBL.SG/2PL.IMP	ground-3SG/OBL.SG
with/at/fear-house	with/at-house
dead-3SG/2PL/OBL.SG/2PL.IMP	dead-3SG/OBL.SG
day-PRES/2SG.PRES/PL	day-PRES/PL
father-PRES/2SG.PRES/PL	father-PRES/PL
something-3SG/2PL/OBL.SG/2PL.IMP	something-3SG/OBL.SG
what.kind.of-1PL/NEG/OBL.PL/DEF	what.kind.of-OBL.PL/DEF
INDEF-REM/2SG/INDEF/CAUS	INDEF-REM
there-COP/PROG	there-COP
SG-2SG/-VITR-3SG-ABL	SG-2SG-ABL
pound/paper-3SG/2PL/OBL.SG/2PL.IMP	pound/paper-3SG/OBL.SG
daf-REM/2SG/INDEF/CAUS	daf-REM/INDEF
month-PRES/2SG.PRES/PL	month-PRES/PL
know-LOC/1SG	know-1SG
say.PFV-PRES/2SG.PRES/PL	say.PFV-PRES/2SG.PRES
necklace-SG-2SG/-VITR-3SG	necklace-SG-2SG
sew-COP/PROG	sew-PROG
door-3SG/2PL/OBL.SG/2PL.IMP	door-3SG/OBL.SG
coat-3SG/2PL/OBL.SG/2PL.IMP	coat-3SG/OBL.SG
LOC-COP/PROG	LOC-COP
LOC/1SG-COP/PROG	LOC-COP
man-1PL/NEG/OBL.PL/DEF	man-OBL.PL/DEF
everything-PRES/2SG.PRES/PL	everything-PRES
SG-2SG/-VITR-3SG-LOC/1SG-PRES/2SG.PRES/PL	SG-2SG-LOC-PRES
with/at/fear-DER	fear-DER
difficult-PRES/2SG.PRES/PL	difficult-
silver-1PL/NEG/OBL.PL/DEF	silver-OBL.PL/DEF
jacket-3SG/2PL/OBL.SG/2PL.IMP	jacket-3SG/OBL.SG
LOC-PRES/2SG.PRES/PL	LOC-PRES
place-DER/-INDEF	place-INDEF
car-1PL/NEG/OBL.PL/DEF	car-OBL.PL/DEF
every/you.VOC-INDEF	every-INDEF
go-VITR/INDEF/3PL/REM/and/2SG	go-REM/2SG
prison-1SG/LOC	prison-LOC
stay-PRES/2SG.PRES/PL	stay-PRES/2SG.PRES
go-LOC/1SG	go-1SG
thousand-3SG/2PL/OBL.SG/2PL.IMP	thousand-3SG/OBL.SG
world-3SG/2PL/OBL.SG/2PL.IMP	world-3SG/OBL.SG
necklace-REM/2SG/INDEF/CAUS	necklace-REM/INDEF
empty-PRES/2SG.PRES/PL	empty-PRES
satan-3SG/2PL/OBL.SG/2PL.IMP	satan-3SG/OBL.SG
lift-COP/PROG	lift-PROG
feel-COP/PROG	feel-COP
house-PRES/2SG.PRES/PL	house-PRES/PL
gold-1PL/NEG/OBL.PL/DEF	gold-OBL.PL/DEF
woman-COP/PROG	woman-COP
where-VITR/INDEF/3PL/REM/and/2SG	where-REM
SIM-PRES/2SG.PRES/PL	SIM-PRES
veil-3SG/2PL/OBL.SG/2PL.IMP	veil-3SG/OBL.SG
tent-3SG/2PL/OBL.SG/2PL.IMP	tent-3SG/OBL.SG
appear-PRES/2SG.PRES/PL	appear-PRES/2SG.PRES
belt-REM/2SG/INDEF/CAUS	belt-REM/INDEF
weld-3SG/2PL/OBL.SG/2PL.IMP	weld-3SG/OBL.SG
tooth-1PL/NEG/OBL.PL/DEF	tooth-OBL.PL/DEF
carton-REM/2SG/INDEF/CAUS	carton-REM/INDEF
dollar-1PL/NEG/OBL.PL/DEF	dollar-OBL.PL/DEF
government/judge-1PL/NEG/OBL.PL/DEF	government/judge-OBL.PL/DEF
school-LOC/1SG-PRES/2SG.PRES/PL	school-LOC-PRES
much-VITR/INDEF/3PL/REM/and/2SG	much-REM
SG-2SG/-VITR-3SG-BEN	SG-2SG-BEN
magazine-REM/2SG/INDEF/CAUS	magazine-REM/INDEF
what.kind.of-1SG/LOC	what.kind.of-LOC
empty-GEN/M/OBL.SG	empty-M
gum-1PL/NEG/OBL.PL/DEF	gum-OBL.PL/DEF
leather-1PL/NEG/OBL.PL/DEF	leather-OBL.PL/DEF
nut-1PL/NEG/OBL.PL/DEF	nut-OBL.PL/DEF
fear-COP/PROG	fear-PROG
ill-PRES/2SG.PRES/PL	ill-PRES
ill-REM/2SG/INDEF/CAUS	ill-REM
pregnant-PRES/2SG.PRES/PL	pregnant-PRES
passport-1PL/NEG/OBL.PL/DEF	passport-OBL.PL/DEF
sock-1PL/NEG/OBL.PL/DEF	sock-OBL.PL/DEF
service-PRES/2SG.PRES/PL	service-PRES/PL
SG-3PL-LOC/1SG-PRES/2SG.PRES/PL	SG-3PL-LOC-PRES
soldier-PRES/2SG.PRES/PL	soldier-PRES/PL
simple-REM/2SG/INDEF/CAUS	 simple-REM/INDEF
Europe-VITR/INDEF/3PL/REM/and/2SG	Europe-INDEF/REM/and
say/good-SUBJ/PROG-3PL-PRES	say-PROG-3PL-PRES
say/good-SUBJ/PROG	say-SUBJ/PROG
get.married-COP/PROG-PRES	get.married-PROG-PRES
get.married-COP/PROG	get.married-PROG
poor-VITR/INDEF/3PL/REM/and/2SG	poor-INDEF/REM/and