aa	 -aa
aak	 -aak
aam	- -aa-m
aan	- -aa-n
aand	- -aa-nd
aar	- -aa-r
aardee	- -aar-d-ee
aas	- -aa-s
aavaa	- -aa-vaa
aavišaa	- -aav-iš-aa
aavišee	- -aav-iš-ee
aavišee	- -aav-iš-ee
aavišind	- -aav-iš-ind
aavišindaa	- -aav-iš-ind-aa
aavišindee	- -aav-iš-ind-ee
aavišinn	- -aav-iš-inn
aavišinnaa	- -aav-iš-inn-aa
aavišinnee	- -aav-iš-inn-ee
aavišiss	- -aav-iš-iss
aavišissaa	- -aav-iš-iss-aa
aavišissee	- -aav-iš-iss-ee
aavišom	- -aav-iš-om
aavišomaa	- -aav-iš-om-aa
aavišomee	- -aav-iš-om-ee
aavišor	- -aav-iš-or
aavišoraa	- -aav-iš-or-aa
aavišoree	- -aav-iš-or-ee
čaa	- -č-aa
ččaa	- -čč-aa
ččim	- -čč-im
ččin	- -čč-in
ččind	- -čč-ind
ččir	- -čč-ir
ččis	- -čč-is
ččris	- -čč-r-is
čim	- -č-im
čin	- -č-in
čind	- -č-ind
čir	- -č-ir
čis	- -č-is
dà	- -d-à
daa	- -d-aa
dee	- -d-ee
dee	- -d-ee
deen	- -d-een
deenaa	- -d-een-aa
deend	- -d-eend
deendaa	- -d-eend-aa
deendee	- -d-eend-ee
deendim	- -d-eend-im
deendimaa	- -d-eend-imaa
deendimaa	- -d-eend-im-aa
deendimaan	- -d-eend-imaan
deendimaanaa	- -d-eend-imaan-aa
deendimaanee	- -d-eend-imaan-ee
deendimee	- -d-eend-im-ee
deendir	- -d-eend-ir
deendiraa	- -d-eend-iraa
deendiraa	- -d-eend-ir-aa
deendiraan	- -d-eend-iraan
deendiraanaa	- -d-eend-iraan-aa
deendiraanee	- -d-eend-iraan-ee
deendiree	- -d-eend-ir-ee
deendis	- -d-eend-is
deendisaa	- -d-eend-isaa
deendisaa	- -d-eend-is-aa
deendisaan	- -d-eend-isaan
deendisaanaa	- -d-eend-isaan-aa
deendisaanee	- -d-eend-isaan-ee
deendisee	- -d-eend-is-ee
deenee	- -d-een-ee
deenir	- -d-een-ir
deeniraa	- -d-een-iraa
deeniraa	- -d-een-ir-aa
deeniraan	- -d-een-iraan
deeniraanaa	- -d-een-iraan-aa
deeniraanee	- -d-een-iraan-ee
deeniree	- -d-een-ir-ee
deenis	- -d-een-is
deenisaa	- -d-een-isaa
deenisaa	- -d-een-is-aa
deenisaan	- -d-een-isaan
deenisaanaa	- -d-een-isaan-aa
deenisaanee	- -d-een-isaan-ee
deenisee	- -d-een-is-ee
dees	- -d-ees
deesaa	- -d-ees-aa
deesee	- -d-ees-ee
deesim	- -d-ees-im
deesimaa	- -d-ees-imaa
deesimaa	- -d-ees-im-aa
deesimaan	- -d-ees-imaan
deesimaanaa	- -d-ees-imaan-aa
deesimaanee	- -d-ees-imaan-ee
deesimee	- -d-ees-im-ee
deesiraa	- -d-ees-iraa
deesiraan	- -d-ees-iraan
deesiraanaa	- -d-ees-iraan-aa
deesiraanee	- -d-ees-iraan-ee
deesis	- -d-ees-is
deesisaa	- -d-ees-is-aa
deesisee	- -d-ees-is-ee
dom	- -d-om
domaa	- -d-om-aa
domee	- -d-om-ee
domir	- -d-om-ir
domiraa	- -d-om-iraa
domiraa	- -d-om-ir-aa
domiraan	- -d-om-iraan
domiraan	- -d-om-iraan
domiraanaa	- -d-om-iraan-aa
domiraanee	- -d-om-iraan-ee
domiree	- -d-om-ir-ee
domis	- -d-om-is
domisaa	- -d-om-isaa
domisaa	- -d-om-is-aa
domisaan	- -d-om-isaan
domisaanaa	- -d-om-isaan-aa
domisaanee	- -d-om-isaan-ee
domisee	- -d-om-is-ee
dor	- -d-or
doraa	- -d-or-aa
doree	- -d-or-ee
dorim	- -d-or-im
dorimaa	- -d-or-imaa
dorimaa	- -d-or-im-aa
dorimaan	- -d-or-imaan
dorimaanaa	- -d-or-imaan-aa
dorimaanee	- -d-or-imaan-ee
dorimee	- -d-or-im-ee
doris	- -d-or-is
dorisaa	- -d-or-isaa
dorisaa	- -d-or-is-aa
dorisaan	- -d-or-isaan
dorisaanaa	- -d-or-isaan-aa
dorisaanee	- -d-or-isaan-ee
dorisee	- -d-or-is-ee
dos	- -d-os
dosim	- -d-os-im
dosimaa	- -d-os-imaa
dosimaa	- -d-os-im-aa
dosimaan	- -d-os-imaan
dosimaanaa	- -d-os-imaan-aa
dosimaanee	- -d-os-imaan-ee
dosimee	- -d-os-im-ee
dosir	- -d-os-ir
dosiraa	- -d-os-iraa
dosiraa	- -d-os-ir-aa
dosiraan	- -d-os-iraan
dosiraanaa	- -d-os-iraan-aa
dosiraanee	- -d-os-iraan-ee
dosiree	- -d-os-ir-ee
dosis	- -d-os-is
dosisaa	- -d-os-isaa
dosisaa	- -d-os-is-aa
dosisaan	- -d-os-isaan
dosisaanaa	- -d-os-isaan-aa
dosisaanee	- -d-os-isaan-ee
dosisee	- -d-os-is-ee
doss	- -d-os-s
eem	 -ee-m
eemaa	 -ee-maa
een	 -een
eenmà	 -een-mà
eentà	 -een-tà
eentaa	 -een-t-aa
eer	 -ee-r
eeraa	 -ee-raa
eeraan	 -ee-raan
ees	 -ee-s
homee	- -ho-m-ee
hondee	- -ho-nd-ee
honee	- -ho-n-ee
horee	- -ho-r-ee
hosee	- -ho-s-ee
howee	- -ho-w-ee
hrà	- -h-r-à
hreen	- -h-r-een
hreend	- -h-r-eend
hrees	- -h-r-ees
hrom	- -h-r-om
hror	- -h-r-or
iččaa	- -ičč-aa
iččim	- -ičč-im
iččin	- -ičč-in
iččind	- -ičč-ind
iččir	- -ičč-ir
iččis	- -ičč-is
idoraa	- -id-or-aa
iin	 -iin
iinee	-iin-ee
iirà	- -ii-r-à
iiraa	- -ii-r-aa
iiree	- -ii-r-ee
iireen	- -ii-r-een
iireend	- -ii-r-eend
iirees	- -ii-r-ees
iirom	- -ii-r-om
iiror	- -ii-r-or
iiš	 -iiš
ika	 -ika
ikaa	 -ikaa
ikeeree	 -ikeeree
ikii	 -ikii
imà	 -imà
imaan	 -imaan
ind	- -ind
indee	- -ind-ee
inkii	 -in-kii
inmà	 -in-mà
insaa	 -in-saa
irà	- -ir-à
iraa	- -ir-aa
iraan	- -iraan
irdà	- -ird-à
irdaa	- -ird-aa
irdee	- -ird-ee
irdeen	- -ird-een
irdeenaa	- -ird-een-aa
irdeend	- -ird-eend
irdeendaa	- -ird-eend-aa
irdeendee	- -ird-eend-ee
irdeendim	- -ird-eend-im
irdeendimaa	- -ird-eend-imaa
irdeendimaa	- -ird-eend-im-aa
irdeendimaan	- -ird-eend-imaan
irdeendimaanaa	- -ird-eend-imaan-aa
irdeendimaanee	- -ird-eend-imaan-ee
irdeendimee	- -ird-eend-im-ee
irdeendir	- -ird-eend-ir
irdeendiraa	- -ird-eend-iraa
irdeendiraa	- -ird-eend-ir-aa
irdeendiraan	- -ird-eend-iraan
irdeendiraanaa	- -ird-eend-iraan-aa
irdeendiraanee	- -ird-eend-iraan-ee
irdeendiree	- -ird-eend-ir-ee
irdeendis	- -ird-eend-is
irdeendisaa	- -ird-eend-isaa
irdeendisaa	- -ird-eend-is-aa
irdeendisaan	- -ird-eend-isaan
irdeendisaanaa	- -ird-eend-isaan-aa
irdeendisaanee	- -ird-eend-isaan-ee
irdeendisee	- -ird-eend-is-ee
irdeenee	- -ird-een-ee
irdeenir	- -ird-een-ir
irdeeniraa	- -ird-een-iraa
irdeeniraa	- -ird-een-ir-aa
irdeeniraan	- -ird-een-iraan
irdeeniraanaa	- -ird-een-iraan-aa
irdeeniraanee	- -ird-een-iraan-ee
irdeeniree	- -ird-een-ir-ee
irdeenis	- -ird-een-is
irdeenisaa	- -ird-een-isaa
irdeenisaa	- -ird-een-is-aa
irdeenisaan	- -ird-een-isaan
irdeenisaanaa	- -ird-een-isaan-aa
irdeenisaanee	- -ird-een-isaan-ee
irdeenisee	- -ird-een-is-ee
irdees	- -ird-ees
irdeesaa	- -ird-ees-aa
irdeesee	- -ird-ees-ee
irdeesim	- -ird-ees-im
irdeesimaa	- -ird-ees-imaa
irdeesimaa	- -ird-ees-im-aa
irdeesimaan	- -ird-ees-imaan
irdeesimaanaa	- -ird-ees-imaan-aa
irdeesimaanee	- -ird-ees-imaan-ee
irdeesimee	- -ird-ees-im-ee
irdeesiraa	- -ird-ees-iraa
irdeesiraan	- -ird-ees-iraan
irdeesiraanaa	- -ird-ees-iraan-aa
irdeesiraanee	- -ird-ees-iraan-ee
irdeesis	- -ird-ees-is
irdeesisaa	- -ird-ees-is-aa
irdeesisee	- -ird-ees-is-ee
irdom	- -ird-om
irdomaa	- -ird-om-aa
irdomee	- -ird-om-ee
irdomir	- -ird-om-ir
irdomiraa	- -ird-om-iraa
irdomiraa	- -ird-om-ir-aa
irdomiraan	- -ird-om-iraan
irdomiraanaa	- -ird-om-iraan-aa
irdomiraanee	- -ird-om-iraan-ee
irdomiree	- -ird-om-ir-ee
irdomis	- -ird-om-is
irdomisaa	- -ird-om-isaa
irdomisaa	- -ird-om-is-aa
irdomisaan	- -ird-om-isaan
irdomisaanaa	- -ird-om-isaan-aa
irdomisaanee	- -ird-om-isaan-ee
irdomisee	- -ird-om-is-ee
irdor	- -ird-or
irdoraa	- -ird-or-aa
irdoree	- -ird-or-ee
irdorim	- -ird-or-im
irdorimaa	- -ird-or-imaa
irdorimaa	- -ird-or-im-aa
irdorimaan	- -ird-or-imaan
irdorimaanaa	- -ird-or-imaan-aa
irdorimaanee	- -ird-or-imaan-ee
irdorimee	- -ird-or-im-ee
irdoris	- -ird-or-is
irdorisaa	- -ird-or-isaa
irdorisaa	- -ird-or-is-aa
irdorisaan	- -ird-or-isaan
irdorisaanaa	- -ird-or-isaan-aa
irdorisaanee	- -ird-or-isaan-ee
irdorisee	- -ird-or-is-ee
irdos	- -ird-os
irdosim	- -ird-os-im
irdosimaa	- -ird-os-imaa
irdosimaa	- -ird-os-im-aa
irdosimaan	- -ird-os-imaan
irdosimaanaa	- -ird-os-imaan-aa
irdosimaanee	- -ird-os-imaan-ee
irdosimee	- -ird-os-im-ee
irdosir	- -ird-os-ir
irdosiraa	- -ird-os-iraa
irdosiraa	- -ird-os-ir-aa
irdosiraan	- -ird-os-iraan
irdosiraanaa	- -ird-os-iraan-aa
irdosiraanee	- -ird-os-iraan-ee
irdosiree	- -ird-os-ir-ee
irdosis	- -ird-os-is
irdosisaa	- -ird-os-isaa
irdosisaa	- -ird-os-is-aa
irdosisaan	- -ird-os-isaan
irdosisaanaa	- -ird-os-isaan-aa
irdosisaanee	- -ird-os-isaan-ee
irdosisee	- -ird-os-is-ee
iree	- -ir-ee
ireen	- -ir-een
ireenaa	- -ir-een-aa
ireend	- -ir-eend
ireendaa	- -ir-eend-aa
irees	- -ir-ees
ireesaa	- -ir-ees-aa
irom	- -ir-om
iromaa	- -ir-om-aa
iror	- -ir-or
iroraa	- -ir-or-aa
iros	- -ir-os
isaa	- -isaa
išaa	- -iš-aa
isaan	- -isaan
išee	- -iš-ee
išimiraa	- -iš-im-ir-aa
išimiraanaa	- -iš-im-iraan-aa
išimiraanee	- -iš-im-iraan-ee
išimiree	- -iš-im-ir-ee
išimisaa	- -iš-im-is-aa
išimisaanaa	- -iš-im-isaan-aa
išimisaanee	- -iš-im-isaan-ee
išimisee	- -iš-im-is-ee
išimraa	- -iš-im-r-aa
išimraanaa	- -iš-im-raan-aa
išimraanee	- -iš-im-raan-ee
išimree	- -iš-im-r-ee
išimsaa	- -iš-im-s-aa
išimsaanaa	- -iš-im-saan-aa
išimsaanee	- -iš-im-saan-ee
išimsee	- -iš-im-s-ee
išind	- -iš-ind
išindaa	- -iš-ind-aa
išindee	- -iš-ind-ee
išindimaa	- -iš-ind-im-aa
išindimaanaa	- -iš-ind-imaan-aa
išindimaanee	- -iš-ind-imaan-ee
išindimee	- -iš-ind-im-ee
išindiraa	- -iš-ind-ir-aa
išindiraanaa	- -iš-ind-iraan-aa
išindiraanee	- -iš-ind-iraan-ee
išindiree	- -iš-ind-ir-ee
išindisaa	- -iš-ind-is-aa
išindisaanaa	- -iš-ind-isaan-aa
išindisaanee	- -iš-ind-isaan-ee
išindisee	- -iš-ind-is-ee
išinn	- -iš-inn
išinnaa	- -iš-inn-aa
išinnee	- -iš-inn-ee
iširimaa	- -iš-ir-im-aa
iširimaanaa	- -iš-ir-imaan-aa
iširimaanee	- -iš-ir-imaan-ee
iširimee	- -iš-ir-im-ee
iširiraa	- -iš-ir-ir-aa
iširiraanaa	- -iš-ir-iraan-aa
iširiraanee	- -iš-ir-iraan-ee
iširiree	- -iš-ir-ir-ee
iširisaa	- -iš-ir-is-aa
iširisaanaa	- -iš-ir-isaan-aa
iširisaanee	- -iš-ir-isaan-ee
iširisee	- -iš-ir-is-ee
iširmaa	- -iš-ir-m-aa
iširmaanaa	- -iš-ir-maan-aa
iširmaanee	- -iš-ir-maan-ee
iširmee	- -iš-ir-m-ee
iširraa	- -iš-ir-r-aa
iširraanaa	- -iš-ir-raan-aa
iširraanee	- -iš-ir-raan-ee
iširree	- -iš-ir-r-ee
iširsaa	- -iš-ir-s-aa
iširsaanaa	- -iš-ir-saan-aa
iširsaanee	- -iš-ir-saan-ee
iširsee	- -iš-ir-s-ee
išism	- -iš-is-m
išismaa	- -iš-is-m-aa
išismaan	- -iš-is-maan
išismaanaa	- -iš-is-maan-aa
išismaanee	- -iš-is-maan-ee
išismee	- -iš-is-m-ee
išisr	- -iš-is-r
išisraa	- -iš-is-r-aa
išisraan	- -iš-is-raan
išisraanaa	- -iš-is-raan-aa
išisraanee	- -iš-is-raan-ee
išisree	- -iš-is-r-ee
išiss	- -iš-iss
išiss	- -iš-is-s
išissaa	- -iš-iss-aa
išissaa	- -iš-is-s-aa
išissaan	- -iš-is-saan
išissaanaa	- -iš-is-saan-aa
išissaanee	- -iš-is-saan-ee
išissee	- -iš-iss-ee
išissee	- -iš-is-s-ee
išmiraa	- -iš-m-ir-aa
išmiraanaa	- -iš-m-iraan-aa
išmiraanee	- -iš-m-iraan-ee
išmiree	- -iš-m-ir-ee
išmisaa	- -iš-m-is-aa
išmisaanaa	- -iš-m-isaan-aa
išmisaanee	- -iš-m-isaan-ee
išmisee	- -iš-m-is-ee
išom	- -iš-om
išomaa	- -iš-om-aa
išomee	- -iš-om-ee
išomiraa	- -iš-om-ir-aa
išomiraanaa	- -iš-om-iraan-aa
išomiraanee	- -iš-om-iraan-ee
išomiree	- -iš-om-ir-ee
išomisaa	- -iš-om-is-aa
išomisaanaa	- -iš-om-isaan-aa
išomisaanee	- -iš-om-isaan-ee
išomisee	- -iš-om-is-ee
išor	- -iš-or
išoraa	- -iš-or-aa
išoree	- -iš-or-ee
išorim	- -iš-or-im
išorimaa	- -iš-or-imaa
išorimaa	- -iš-or-im-aa
išorimaan	- -iš-or-imaan
išorimaanaa	- -iš-or-imaan-aa
išorimaanee	- -iš-or-imaan-ee
išorimee	- -iš-or-im-ee
išoris	- -iš-or-is
išorisaa	- -iš-or-isaa
išorisaa	- -iš-or-is-aa
išorisaan	- -iš-or-isaan
išorisaanaa	- -iš-or-isaan-aa
išorisaanee	- -iš-or-isaan-ee
išorisee	- -iš-or-is-ee
išormaa	- -iš-or-m-aa
išormaanaa	- -iš-or-maan-aa
išormaanee	- -iš-or-maan-ee
išormee	- -iš-or-m-ee
išorsaa	- -iš-or-s-aa
išorsaanaa	- -iš-or-saan-aa
išorsaanee	- -iš-or-saan-ee
išorsee	- -iš-or-s-ee
išrimaa	- -iš-r-im-aa
išrimaanaa	- -iš-r-imaan-aa
išrimaanee	- -iš-r-imaan-ee
išrimee	- -iš-r-im-ee
išriraa	- -iš-r-ir-aa
išriraanaa	- -iš-r-iraan-aa
išriraanee	- -iš-r-iraan-ee
išriree	- -iš-r-ir-ee
išrisaa	- -iš-r-is-aa
išrisaanaa	- -iš-r-isaan-aa
išrisaanee	- -iš-r-isaan-ee
išrisee	- -iš-r-is-ee
iššaa	- -išš-aa
iššaaee	- -išš-aa-ee
iššim	- -išš-im
iššimee	- -išš-im-ee
iššin	- -išš-in
iššind	- -išš-ind
iššindee	- -išš-ind-ee
iššinee	- -išš-in-ee
iššir	- -išš-ir
išširee	- -išš-ir-ee
iššis	- -išš-is
iššisee	- -išš-is-ee
ištaa	- -išt-aa
ištee	- -išt-ee
ištind	- -išt-ind
ištindaa	- -išt-ind-aa
ištindee	- -išt-ind-ee
ištinn	- -išt-inn
ištinnaa	- -išt-inn-aa
ištinnee	- -išt-inn-ee
ištiss	- -išt-iss
ištissaa	- -išt-iss-aa
ištissee	- -išt-iss-ee
ištom	- -išt-om
ištomaa	- -išt-om-aa
ištomee	- -išt-om-ee
ištor	- -išt-or
ištoraa	- -išt-or-aa
ištoree	- -išt-or-ee
it	 -it
ità	 -ità
itišaa	- -itiš-aa
itišee	- -itiš-ee
itišimiraa	- -itiš-im-ir-aa
itišimiraanaa	- -itiš-im-iraan-aa
itišimiraanee	- -itiš-im-iraan-ee
itišimiree	- -itiš-im-ir-ee
itišimisaa	- -itiš-im-is-aa
itišimisaanaa	- -itiš-im-isaan-aa
itišimisaanee	- -itiš-im-isaan-ee
itišimisee	- -itiš-im-is-ee
itišimraa	- -itiš-im-r-aa
itišimraanaa	- -itiš-im-raan-aa
itišimraanee	- -itiš-im-raan-ee
itišimree	- -itiš-im-r-ee
itišimsaa	- -itiš-im-s-aa
itišimsaanaa	- -itiš-im-saan-aa
itišimsaanee	- -itiš-im-saan-ee
itišimsee	- -itiš-im-s-ee
itišind	- -itiš-ind
itišindaa	- -itiš-ind-aa
itišindee	- -itiš-ind-ee
itišindimaa	- -itiš-ind-im-aa
itišindimaanaa	- -itiš-ind-imaan-aa
itišindimaanee	- -itiš-ind-imaan-ee
itišindimee	- -itiš-ind-im-ee
itišindiraa	- -itiš-ind-ir-aa
itišindiraanaa	- -itiš-ind-iraan-aa
itišindiraanee	- -itiš-ind-iraan-ee
itišindiree	- -itiš-ind-ir-ee
itišindisaa	- -itiš-ind-is-aa
itišindisaanaa	- -itiš-ind-isaan-aa
itišindisaanee	- -itiš-ind-isaan-ee
itišindisee	- -itiš-ind-is-ee
itišinn	- -itiš-inn
itišinnaa	- -itiš-inn-aa
itišinnee	- -itiš-inn-ee
itiširimaa	- -itiš-ir-im-aa
itiširimaanaa	- -itiš-ir-imaan-aa
itiširimaanee	- -itiš-ir-imaan-ee
itiširimee	- -itiš-ir-im-ee
itiširiraa	- -itiš-ir-ir-aa
itiširiraanaa	- -itiš-ir-iraan-aa
itiširiraanee	- -itiš-ir-iraan-ee
itiširiree	- -itiš-ir-ir-ee
itiširisaa	- -itiš-ir-is-aa
itiširisaanaa	- -itiš-ir-isaan-aa
itiširisaanee	- -itiš-ir-isaan-ee
itiširisee	- -itiš-ir-is-ee
itiširmaa	- -itiš-ir-m-aa
itiširmaanaa	- -itiš-ir-maan-aa
itiširmaanee	- -itiš-ir-maan-ee
itiširmee	- -itiš-ir-m-ee
itiširraa	- -itiš-ir-r-aa
itiširraanaa	- -itiš-ir-raan-aa
itiširraanee	- -itiš-ir-raan-ee
itiširree	- -itiš-ir-r-ee
itiširsaa	- -itiš-ir-s-aa
itiširsaanaa	- -itiš-ir-saan-aa
itiširsaanee	- -itiš-ir-saan-ee
itiširsee	- -itiš-ir-s-ee
itišism	- -itiš-is-m
itišismaa	- -itiš-is-m-aa
itišismaan	- -itiš-is-maan
itišismaanaa	- -itiš-is-maan-aa
itišismaanee	- -itiš-is-maan-ee
itišismee	- -itiš-is-m-ee
itišisr	- -itiš-is-r
itišisraa	- -itiš-is-r-aa
itišisraan	- -itiš-is-raan
itišisraanaa	- -itiš-is-raan-aa
itišisraanee	- -itiš-is-raan-ee
itišisree	- -itiš-is-r-ee
itišiss	- -itiš-iss
itišiss	- -itiš-is-s
itišissaa	- -itiš-iss-aa
itišissaa	- -itiš-is-s-aa
itišissaan	- -itiš-is-saan
itišissaanaa	- -itiš-is-saan-aa
itišissaanee	- -itiš-is-saan-ee
itišissee	- -itiš-iss-ee
itišissee	- -itiš-is-s-ee
itišmiraa	- -itiš-m-ir-aa
itišmiraanaa	- -itiš-m-iraan-aa
itišmiraanee	- -itiš-m-iraan-ee
itišmiree	- -itiš-m-ir-ee
itišmisaa	- -itiš-m-is-aa
itišmisaanaa	- -itiš-m-isaan-aa
itišmisaanee	- -itiš-m-isaan-ee
itišmisee	- -itiš-m-is-ee
itišom	- -itiš-om
itišomaa	- -itiš-om-aa
itišomee	- -itiš-om-ee
itišomiraa	- -itiš-om-ir-aa
itišomiraanaa	- -itiš-om-iraan-aa
itišomiraanee	- -itiš-om-iraan-ee
itišomiree	- -itiš-om-ir-ee
itišomisaa	- -itiš-om-is-aa
itišomisaanaa	- -itiš-om-isaan-aa
itišomisaanee	- -itiš-om-isaan-ee
itišomisee	- -itiš-om-is-ee
itišor	- -itiš-or
itišoraa	- -itiš-or-aa
itišoree	- -itiš-or-ee
itišorim	- -itiš-or-im
itišorimaa	- -itiš-or-imaa
itišorimaa	- -itiš-or-im-aa
itišorimaan	- -itiš-or-imaan
itišorimaanaa	- -itiš-or-imaan-aa
itišorimaanee	- -itiš-or-imaan-ee
itišorimee	- -itiš-or-im-ee
itišoris	- -itiš-or-is
itišorisaa	- -itiš-or-isaa
itišorisaa	- -itiš-or-is-aa
itišorisaan	- -itiš-or-isaan
itišorisaanaa	- -itiš-or-isaan-aa
itišorisaanee	- -itiš-or-isaan-ee
itišorisee	- -itiš-or-is-ee
itišormaa	- -itiš-or-m-aa
itišormaanaa	- -itiš-or-maan-aa
itišormaanee	- -itiš-or-maan-ee
itišormee	- -itiš-or-m-ee
itišorsaa	- -itiš-or-s-aa
itišorsaanaa	- -itiš-or-saan-aa
itišorsaanee	- -itiš-or-saan-ee
itišorsee	- -itiš-or-s-ee
itišrimaa	- -itiš-r-im-aa
itišrimaanaa	- -itiš-r-imaan-aa
itišrimaanee	- -itiš-r-imaan-ee
itišrimee	- -itiš-r-im-ee
itišriraa	- -itiš-r-ir-aa
itišriraanaa	- -itiš-r-iraan-aa
itišriraanee	- -itiš-r-iraan-ee
itišriree	- -itiš-r-ir-ee
itišrisaa	- -itiš-r-is-aa
itišrisaanaa	- -itiš-r-isaan-aa
itišrisaanee	- -itiš-r-isaan-ee
itišrisee	- -itiš-r-is-ee
iva	 -iva
ivaa	 -ivaa
ka	 -ka
kà	 -kà
kaa	 -kaa
kar	- -kar
kardà	- -kar-d-à
kardaa	- -kar-d-aa
kardee	- -kar-d-ee
kardeen	- -kar-d-een
kardeenaa	- -kar-d-een-aa
kardeend	- -kar-d-eend
kardeendaa	- -kar-d-eend-aa
kardeendim	- -kar-d-eend-im
kardeendimaa	- -kar-d-eend-imaa
kardeendimaa	- -kar-d-eend-im-aa
kardeendimaan	- -kar-d-eend-imaan
kardeendimaanaa	- -kar-d-eend-imaan-aa
kardeendimaanee	- -kar-d-eend-imaan-ee
kardeendimee	- -kar-d-eend-im-ee
kardeendir	- -kar-d-eend-ir
kardeendiraa	- -kar-d-eend-iraa
kardeendiraa	- -kar-d-eend-ir-aa
kardeendiraan	- -kar-d-eend-iraan
kardeendiraanaa	- -kar-d-eend-iraan-aa
kardeendiraanee	- -kar-d-eend-iraan-ee
kardeendiree	- -kar-d-eend-ir-ee
kardeendis	- -kar-d-eend-is
kardeendisaa	- -kar-d-eend-isaa
kardeendisaa	- -kar-d-eend-is-aa
kardeendisaan	- -kar-d-eend-isaan
kardeendisaanaa	- -kar-d-eend-isaan-aa
kardeendisaanee	- -kar-d-eend-isaan-ee
kardeendisee	- -kar-d-eend-is-ee
kardeenir	- -kar-d-een-ir
kardeeniraa	- -kar-d-een-iraa
kardeeniraa	- -kar-d-een-ir-aa
kardeeniraan	- -kar-d-een-iraan
kardeeniraanaa	- -kar-d-een-iraan-aa
kardeeniraanee	- -kar-d-een-iraan-ee
kardeeniree	- -kar-d-een-ir-ee
kardeenis	- -kar-d-een-is
kardeenisaa	- -kar-d-een-isaa
kardeenisaa	- -kar-d-een-is-aa
kardeenisaan	- -kar-d-een-isaan
kardeenisaanaa	- -kar-d-een-isaan-aa
kardeenisaanee	- -kar-d-een-isaan-ee
kardeenisee	- -kar-d-een-is-ee
kardees	- -kar-d-ees
kardeesaa	- -kar-d-ees-aa
kardeesim	- -kar-d-ees-im
kardeesimaa	- -kar-d-ees-imaa
kardeesimaa	- -kar-d-ees-im-aa
kardeesimaan	- -kar-d-ees-imaan
kardeesimaanaa	- -kar-d-ees-imaan-aa
kardeesimaanee	- -kar-d-ees-imaan-ee
kardeesimee	- -kar-d-ees-im-ee
kardeesiraa	- -kar-d-ees-iraa
kardeesiraan	- -kar-d-ees-iraan
kardeesiraanaa	- -kar-d-ees-iraan-aa
kardeesiraanee	- -kar-d-ees-iraan-ee
kardeesis	- -kar-d-ees-is
kardeesisaa	- -kar-d-ees-is-aa
kardeesisee	- -kar-d-ees-is-ee
kardom	- -kar-d-om
kardomaa	- -kar-d-om-aa
kardomir	- -kar-d-om-ir
kardomiraa	- -kar-d-om-iraa
kardomiraa	- -kar-d-om-ir-aa
kardomiraan	- -kar-d-om-iraan
kardomiraan	- -kar-d-om-iraan
kardomiraanaa	- -kar-d-om-iraan-aa
kardomiraanee	- -kar-d-om-iraan-ee
kardomiree	- -kar-d-om-ir-ee
kardomis	- -kar-d-om-is
kardomisaa	- -kar-d-om-isaa
kardomisaa	- -kar-d-om-is-aa
kardomisaan	- -kar-d-om-isaan
kardomisaanaa	- -kar-d-om-isaan-aa
kardomisaanee	- -kar-d-om-isaan-ee
kardomisee	- -kar-d-om-is-ee
kardor	- -kar-d-or
kardoraa	- -kar-d-or-aa
kardorim	- -kar-d-or-im
kardorimaa	- -kar-d-or-imaa
kardorimaa	- -kar-d-or-im-aa
kardorimaan	- -kar-d-or-imaan
kardorimaanaa	- -kar-d-or-imaan-aa
kardorimaanee	- -kar-d-or-imaan-ee
kardorimee	- -kar-d-or-im-ee
kardoris	- -kar-d-or-is
kardorisaa	- -kar-d-or-isaa
kardorisaa	- -kar-d-or-is-aa
kardorisaan	- -kar-d-or-isaan
kardorisaanaa	- -kar-d-or-isaan-aa
kardorisaanee	- -kar-d-or-isaan-ee
kardorisee	- -kar-d-or-is-ee
kardos	- -kar-d-os
kardosim	- -kar-d-os-im
kardosimaa	- -kar-d-os-imaa
kardosimaa	- -kar-d-os-im-aa
kardosimaan	- -kar-d-os-imaan
kardosimaanaa	- -kar-d-os-imaan-aa
kardosimaanee	- -kar-d-os-imaan-ee
kardosimee	- -kar-d-os-im-ee
kardosir	- -kar-d-os-ir
kardosiraa	- -kar-d-os-iraa
kardosiraa	- -kar-d-os-ir-aa
kardosiraan	- -kar-d-os-iraan
kardosiraanaa	- -kar-d-os-iraan-aa
kardosiraanee	- -kar-d-os-iraan-ee
kardosiree	- -kar-d-os-ir-ee
kardosis	- -kar-d-os-is
kardosisaa	- -kar-d-os-isaa
kardosisaa	- -kar-d-os-is-aa
kardosisaan	- -kar-d-os-isaan
kardosisaanaa	- -kar-d-os-isaan-aa
kardosisaanee	- -kar-d-os-isaan-ee
kardosisee	- -kar-d-os-is-ee
karim	- -kar-im
karimaa	- -kar-im-aa
karinaa	- -kar-in-aa
karindaa	- -kar-ind-aa
kariraa	- -kar-ir-aa
karosaanee	- -kar-osaan-ee
karree	- -kar-r-ee
karraa	- -kar-r-aa
karrimee	- -kar-r-im-ee
karrisaa	- -kar-r-is-aa
karrisee	- -kar-r-is-ee
karsim	- -kar-s-im
karsimaa	- -kar-s-imaa
karsimaan	- -kar-s-imaan
simaa	- -s-imaa
karsir	- -kar-s-ir
karsiraa	- -kar-s-iraa
karsiraan	- -kar-s-iraan
karsis	- -kar-s-is
karsisaa	- -kar-s-isaa
karsisaan	- -kar-s-isaan
kašaaee	- -ka-š-aa-ee
kašimee	- -ka-š-im-ee
kašindee	- -ka-š-ind-ee
kašinee	- -ka-š-in-ee
kaširee	- -ka-š-ir-ee
kašisee	- -ka-š-is-ee
kašt	- -ka-št
kaštaa	- -ka-št-aa
kaštee	- -ka-št-ee
kaštind	- -ka-št-ind
kaštindaa	- -ka-št-ind-aa
kaštindee	- -ka-št-ind-ee
kaštinn	- -ka-št-inn
kaštinnaa	- -ka-št-inn-aa
kaštinnee	- -ka-št-inn-ee
kaštiss	- -ka-št-iss
kaštissaa	- -ka-št-iss-aa
kaštissee	- -ka-št-iss-ee
kaštom	- -ka-št-om
kaštomaa	- -ka-št-om-aa
kaštomee	- -ka-št-om-ee
kaštor	- -ka-št-or
kaštoraa	- -ka-št-or-aa
kaštoree	- -ka-št-or-ee
keer	 -keer
keera	 -keera
keerà	 -keerà
keeree	 -keeree
keerom	 -keer-om
keeromaa	 -keer-omaa
keeromaan	 -keer-omaan
keeror	 -keer-or
keeroraa	 -keer-oraa
keeroraan	 -keer-oraan
keeros	 -keer-os
keerosaa	 -keer-osaa
keerosaan	 -keer-osaan
kii	 -kii
krà	- -k-r-à
kraa	- -k-r-aa
kree	- -k-r-ee
kreen	- -k-r-een
kreenaa	- -k-r-een-aa
kreend	- -k-r-eend
kreendaa	- -k-r-eend-aa
kreendim	- -k-r-eend-im
kreendimaa	- -k-r-eend-imaa
kreenee	- -k-r-een-ee
kreenim	- -k-r-een-im
kreenimaa	- -k-r-een-imaa
kreenimaan	- -k-r-een-imaan
kreenir	- -k-r-een-ir
kreeniraa	- -k-r-een-iraa
kreeniraan	- -k-r-een-iraan
kreenis	- -k-r-een-is
kreenisaa	- -k-r-een-isaa
kreenisaan	- -k-r-een-isaan
krees	- -k-r-ees
kreesaa	- -k-r-ees-aa
krom	- -k-r-om
kromaa	- -k-r-om-aa
kroomee	- -k-r-oom-ee
kror	- -k-r-or
kroraa	- -k-r-or-aa
kros	- -k-r-os
kross	- -k-r-os-s
là	- -l-à
lee	- -l-ee
lee	- -l-ee
lee	- -l-ee
leen	- -l-een
ma	 -ma
mà	 -mà
mee	- -m-ee
mor	 -mor
naam	- -naa-m
ndee	- -nd-ee
nee	- -n-ee
očaa	- -o-č-aa
oččaa	- -o-čč-aa
oččim	- -o-čč-im
oččin	- -o-čč-in
oččind	- -o-čč-ind
oččir	- -o-čč-ir
oččis	- -o-čč-is
očer	- -o-č-er
očim	- -o-č-im
očimir	- -o-č-im-ir
očin	- -o-č-in
očind	- -o-č-ind
očir	- -o-č-ir
očis	- -o-č-is
om	 -o-m
omaa	 -o-maa
omaan	 -o-maan
omee	- -o-m-ee
ondee	- -o-nd-ee
ondis	- -ond-is
onee	- -o-n-ee
or	- -o-r
oraa	- -o-raa
oraan	- -o-raan
oree	- -o-r-ee
os	 -o-s
osaa	 -o-saa
osaan	 -o-saan
osee	- -o-s-ee
otii	- -o-tii
owee	- -o-w-ee
rà	- -r-à
raa	- -raa
raa	- -r-aa
rdà	- -rd-à
rdaa	- -rd-aa
rdeen	- -rd-een
rdeenaa	- -rd-een-aa
rdeend	- -rd-eend
rdeendaa	- -rd-eend-aa
rdeendim	- -rd-eend-im
rdeendimaa	- -rd-eend-imaa
rdeendimaa	- -rd-eend-im-aa
rdeendimaan	- -rd-eend-imaan
rdeendimaanaa	- -rd-eend-imaan-aa
rdeendimaanee	- -rd-eend-imaan-ee
rdeendimee	- -rd-eend-im-ee
rdeendir	- -rd-eend-ir
rdeendiraa	- -rd-eend-iraa
rdeendiraa	- -rd-eend-ir-aa
rdeendiraan	- -rd-eend-iraan
rdeendiraanaa	- -rd-eend-iraan-aa
rdeendiraanee	- -rd-eend-iraan-ee
rdeendiree	- -rd-eend-ir-ee
rdeendis	- -rd-eend-is
rdeendisaa	- -rd-eend-isaa
rdeendisaa	- -rd-eend-is-aa
rdeendisaan	- -rd-eend-isaan
rdeendisaanaa	- -rd-eend-isaan-aa
rdeendisaanee	- -rd-eend-isaan-ee
rdeendisee	- -rd-eend-is-ee
rdeenir	- -rd-een-ir
rdeeniraa	- -rd-een-iraa
rdeeniraa	- -rd-een-ir-aa
rdeeniraan	- -rd-een-iraan
rdeeniraanaa	- -rd-een-iraan-aa
rdeeniraanee	- -rd-een-iraan-ee
rdeeniree	- -rd-een-ir-ee
rdeenis	- -rd-een-is
rdeenisaa	- -rd-een-isaa
rdeenisaa	- -rd-een-is-aa
rdeenisaan	- -rd-een-isaan
rdeenisaanaa	- -rd-een-isaan-aa
rdeenisaanee	- -rd-een-isaan-ee
rdeenisee	- -rd-een-is-ee
rdees	- -rd-ees
rdeesaa	- -rd-ees-aa
rdeesim	- -rd-ees-im
rdeesimaa	- -rd-ees-imaa
rdeesimaa	- -rd-ees-im-aa
rdeesimaan	- -rd-ees-imaan
rdeesimaanaa	- -rd-ees-imaan-aa
rdeesimaanee	- -rd-ees-imaan-ee
rdeesimee	- -rd-ees-im-ee
rdeesiraa	- -rd-ees-iraa
rdeesiraan	- -rd-ees-iraan
rdeesiraanaa	- -rd-ees-iraan-aa
rdeesiraanee	- -rd-ees-iraan-ee
rdeesis	- -rd-ees-is
rdeesisaa	- -rd-ees-is-aa
rdeesisee	- -rd-ees-is-ee
rdom	- -rd-om
rdomaa	- -rd-om-aa
rdomir	- -rd-om-ir
rdomiraa	- -rd-om-iraa
rdomiraa	- -rd-om-ir-aa
rdomiraan	- -rd-om-iraan
rdomiraanaa	- -rd-om-iraan-aa
rdomiraanee	- -rd-om-iraan-ee
rdomiree	- -rd-om-ir-ee
rdomis	- -rd-om-is
rdomisaa	- -rd-om-isaa
rdomisaa	- -rd-om-is-aa
rdomisaan	- -rd-om-isaan
rdomisaanaa	- -rd-om-isaan-aa
rdomisaanee	- -rd-om-isaan-ee
rdomisee	- -rd-om-is-ee
rdor	- -rd-or
rdorim	- -rd-or-im
rdorimaa	- -rd-or-imaa
rdorimaa	- -rd-or-im-aa
rdorimaan	- -rd-or-imaan
rdorimaanaa	- -rd-or-imaan-aa
rdorimaanee	- -rd-or-imaan-ee
rdorimee	- -rd-or-im-ee
rdoris	- -rd-or-is
rdorisaa	- -rd-or-isaa
rdorisaa	- -rd-or-is-aa
rdorisaan	- -rd-or-isaan
rdorisaanaa	- -rd-or-isaan-aa
rdorisaanee	- -rd-or-isaan-ee
rdorisee	- -rd-or-is-ee
rdos	- -rd-os
rdosim	- -rd-os-im
rdosimaa	- -rd-os-imaa
rdosimaa	- -rd-os-im-aa
rdosimaan	- -rd-os-imaan
rdosimaanaa	- -rd-os-imaan-aa
rdosimaanee	- -rd-os-imaan-ee
rdosimee	- -rd-os-im-ee
rdosir	- -rd-os-ir
rdosiraa	- -rd-os-iraa
rdosiraa	- -rd-os-ir-aa
rdosiraan	- -rd-os-iraan
rdosiraanaa	- -rd-os-iraan-aa
rdosiraanee	- -rd-os-iraan-ee
rdosiree	- -rd-os-ir-ee
rdosis	- -rd-os-is
rdosisaa	- -rd-os-isaa
rdosisaa	- -rd-os-is-aa
rdosisaan	- -rd-os-isaan
rdosisaanaa	- -rd-os-isaan-aa
rdosisaanee	- -rd-os-isaan-ee
rdosisee	- -rd-os-is-ee
ree	- -r-ee
reen	- -r-een
reenaa	- -r-een-aa
reend	- -r-eend
reendaa	- -r-eend-aa
reendee	- -r-eend-ee
reendimaa	- -r-eend-imaa
reendimee	- -r-eend-im-ee
reendiree	- -r-eend-ir-ee
reendisee	- -r-eend-is-ee
reendis	- -r-eend-is
rees	- -r-ees
reesaa	- -r-ees-aa
rom	- -r-om
romaa	- -r-om-aa
roomee	- -r-oom-ee
ror	- -r-or
roraa	- -r-or-aa
ros	- -r-os
sa	 -sa
saa	 -saa
šaa	- -š-aa
šaaee	- -š-aa-ee
saan	- -saan
see	- -see
šee	- -š-ee
šim	- -š-im
šimee	- -š-im-ee
šin	- -š-in
šind	- -š-ind
šindee	- -š-ind-ee
šinee	- -š-in-ee
inee	- -in-ee
šir	- -š-ir
širee	- -š-ir-ee
šis	- -š-is
šisee	- -š-is-ee
ssa	- -ssa
ššaa	- -šš-aa
ššaaee	- -šš-aa-ee
ššim	- -šš-im
ššimee	- -šš-im-ee
ššin	- -šš-in
ššind	- -šš-ind
ššindee	- -šš-ind-ee
ššinee	- -šš-in-ee
ššir	- -šš-ir
šširee	- -šš-ir-ee
ššis	- -šš-is
ššisee	- -šš-is-ee
št	- -št
štaa	- -št-aa
štee	- -št-ee
štind	- -št-ind
štindaa	- -št-ind-aa
štindee	- -št-ind-ee
štinn	- -št-inn
štinnaa	- -št-inn-aa
štinnee	- -št-inn-ee
štiss	- -št-iss
štissaa	- -št-iss-aa
štissee	- -št-iss-ee
štom	- -št-om
štomaa	- -št-om-aa
štomee	- -št-om-ee
štor	- -št-or
štoraa	- -št-or-aa
štoree	- -št-or-ee
ta	 -ta
tà	 -tà
tar	 -tar
ttà	- -tt-à
ttaa	- -tt-aa
tteen	- -tt-een
tteenaa	- -tt-een-aa
tteend	- -tt-eend
tteendaa	- -tt-eend-aa
ttees	- -tt-ees
tteesaa	- -tt-ees-aa
ttom	- -tt-om
ttomaa	- -tt-om-aa
ttor	- -tt-or
ttoraa	- -tt-or-aa
va	 -va
vaa	 -vaa
vaar	 -vaar
ya	 -ya
yaa	 -yaa
yaan	 -yaan
yaaraa	- -yaa-r-aa
yaaree	- -yaa-r-ee
yi	 -yi
yiin	 -yiin
yin	 -yin
yis	 -yis
yiš	 -yiš
ašee	aš-ee
aštaa	ašt-aa
aštaa	ašt-aa
aštee	ašt-ee
aštee	ašt-ee
paaṣi	paaṣ-i
paaṣii	paaṣ-ii
paaṣom	paaṣ-om
paaṣomaa	paaṣ-omaa
paaṣomaan	paaṣ-omaan
paaṣor	paaṣ-or
paaṣoraa	paaṣ-oraa
paaṣoraan	paaṣ-oraan
paaṣyaa	paaṣ-yaa
paaṣyaan	paaṣ-yaan
pačom	pač-om
pačomaa	pač-omaa
pačomaan	pač-omaan
pačor	pač-or
pačoraa	pač-oraa
pačoraan	pač-oraan
pačos	pač-os
pačosaa	pač-osaa
pačosaan	pač-osaan
tità	tit-à
tom	t-om
tor	t-or
tos	t-os
vaaši	vaaš-i
vaašii	vaaš-ii
vaašom	vaaš-om
vaašor	vaaš-or
vaašyaa	vaaš-yaa
vaašyaan	vaaš-yaan
vagrom	vagr-om
vagromaa	vagr-omaa
vagromaan	vagr-omaan
vagror	vagr-or
vagroraa	vagr-oraa
vagroraan	vagr-oraan
vagros	vagr-os
vagrosaa	vagr-osaa
vagrosaan	vagr-osaan
vati	vat-i
vatii	vat-ii
vatom	vat-om
vatomaa	vat-omaa
vatomaan	vat-omaan
vator	vat-or
vatoraa	vat-oraa
vatoraan	vat-oraan
vatyaa	vat-yaa
vatyaan	vat-yaan
veešii	veeš-ii
veešom	veeš-om
veešomaa	veeš-omaa
veešomaan	veeš-omaan
veešor	veeš-or
veešoraa	veeš-oraa
veešoraan	veeš-oraan
veešyaa	veeš-yaa
aakkii	 -aak-kii
aborkeeree	ab-or -keeree
karindee	- -kar-ind-ee
karmee	- -kar-m-ee
adii	 -adii
yim	  -yim
eesaa	 -ee-saa
leend	 - -l-eend
im	 -im
menjii	menj-ii
eesaan	 -ee-saan
naa	 -- -n-aa
aardeendimaan	- -aa-rd-eend-imaan
išnee	- -iš-n-ee
aandee	- -aa-nd-ee
kaanya	kaany-a
kaanyaa	kaany-aa
kaanyee	kaany-ee
omkii	 -o-m -kii
orkii	 -o-r -kii
oskii	 -o-s -kii
kaanyee	kaany-ee
kaanyaa	kaany-aa
abomaakeeree	ab-omaa -keeree
naadà	- -naa-d-à
naadaa	- -naa-d-aa
naadee	- -naa-d-ee
naadeen	- -naa-d-een
naadeenaa	- -naa-d-een-aa
naadeenee	- -naa-d-een-ee
naadeend	- -naa-d-eend
naadeendaa	- -naa-d-eend-aa
naadeendee	- -naa-d-eend-ee
naadeendisee	- -naa-d-eend-is-ee
naadeendisaa	- -naa-d-eend-is-aa
naadeendim	- -naa-d-eend-im
naadeendimee	- -naa-d-eend-im-ee
naadeendimaa	- -naa-d-eend-im-aa
naadeendiree	- -naa-d-eend-ir-ee
naadeendiraa	- -naa-d-eend-ir-aa
naadees	- -naa-d-ees
naadeesaa	- -naa-d-ees-aa
naadeesee	- -naa-d-ees-ee
naadom	- -naa-d-om
naadomaa	- -naa-d-om-aa
naadomee	- -naa-d-om-ee
naador	- -naa-d-or
naadoree	- -naa-d-or-ee
naados	- -naa-d-os
naadosim	- -naa-d-os-im
naadosir	- -naa-d-os-ir
naadosis	- -naa-d-os-is
naadosimaa	- -naa-d-os-imaa
naadosiraa	- -naa-d-os-iraa
naadosisaa	- -naa-d-os-isaa
naadosimaan	- -naa-d-os-imaan
naadosiraan	- -naa-d-os-iraan
naadosisaan	- -naa-d-os-isaan
naainaa	- -naa-in-aa
naainee	- -naa-in-ee
naaindaa	- -naa-ind-aa
naaindee	- -naa-ind-ee
naaisaa	- -naa-is-aa
naaisee	- -naa-is-ee
naam	- -naa-m
naamaa	- -naa-m-aa
naamee	- -naa-m-ee
naandaa	- -naa-nd-aa
naandee	- -naa-nd-ee
naandisee	- -naa-nd-is-ee
naandisaa	- -naa-nd-is-aa
naandis	- -naa-nd-is
naar	- -naa-r
naaraa	- -naa-r-aa
naaree	- -naa-r-ee
naarà	- -naa-r-à
naardà	- -naa-rd-à
naardaa	- -naa-rd-aa
naardee	- -naa-rd-ee
naardeen	- -naa-rd-een
naardeenaa	- -naa-rd-een-aa
naardeenee	- -naa-rd-een-ee
naardeend	- -naa-rd-eend
naardeendaa	- -naa-rd-eend-aa
naardeendee	- -naa-rd-eend-ee
naardees	- -naa-rd-ees
naardeesaa	- -naa-rd-ees-aa
naardeesee	- -naa-rd-ees-ee
naardom	- -naa-rd-om
naardomaa	- -naa-rd-om-aa
naardomee	- -naa-rd-om-ee
naardor	- -naa-rd-or
naardoree	- -naa-rd-or-ee
naardos	- -naa-rd-os
naaav	- -naaav
naar	- -naar
naavištaa	- -naav-išt-aa
naavištee	- -naav-išt-ee
naavištind	- -naav-išt-ind
indaa	- -ind-aa
naavištindaa	- -naav-išt-ind-aa
naavištindee	- -naav-išt-ind-ee
naavištinn	- -naav-išt-inn
naavištinnaa	- -naav-išt-inn-aa
naavištinnee	- -naav-išt-inn-ee
naavištirsee	- -naav-išt-ir-s-ee
naavištiss	- -naav-išt-iss
naavištissaa	- -naav-išt-iss-aa
naavištissee	- -naav-išt-iss-ee
naavištom	- -naav-išt-om
naavištomaa	- -naav-išt-om-aa
naavištomee	- -naav-išt-om-ee
naavištor	- -naav-išt-or
naavištoraa	- -naav-išt-or-aa
naavištoree	- -naav-išt-or-ee
misaanaa	- -m-isaan-aa
indsaa	- -ind-s-aa
aadà	- -aa-d-à
aadeend	- -aa-d-eend
aadeenis	- -aa-d-een-is
aardà	- -aa-rd-à
aardeendimaan	- -aa-rd-eend-imaan
aamaa	- -aa-m-aa
irdoss	- -ird-os-s
ištirree	- -išt-ir-r-ee
wosaa	- -w-osaa
ortà	-o-r -tà
omtà	-o-m -tà
ostà	-o-s -tà
oraantà	-o-raan -tà
oraatà	-o-raa -tà
omaantà	-o-maan -tà
nsaa	- -n-saa
omaatà	-o-maa -tà
osaantà	-o-saan -tà
osaatà	-o-saa -tà
isisaanaa	- -is-isaan-aa
isisaaaa	- -is-isaa-aa
isisaanee	- -is-isaan-ee
isisaaee	- -is-isaa-ee
isisaan	- -is-isaan
isisaa	- -is-isaa
ossee	- -os-s-ee
romis	- -r-om-is
karsaa	- -kar-s-aa
karnaa	- -kar-n-aa